第二: dì èr
小腿: xiǎo tuǐ
汇理: huì lǐ
第五: dì wǔ
俗话: sú huà
困境: kùn jìng
急驰: jí chí
升起: shēng qǐ
起诉: qǐ sù
贺元: hè yuán
盈利: yíng lì
荣星: róng xīng
第三: dì sān
Ｒ·Ｈ·梅西: Ｒ · Ｈ · méi xī
黎志文: lí zhì wén
凑近: còu jìn
势力: shì lì
开工: kāi gōng
兼顾: jiān gù
纸张: zhǐ zhāng
性爱: xìng ài
十来: shí lái
蜜蜂: mì fēng
开展: kāi zhǎn
外墙: wài qiáng
消费类: xiāo fèi lèi
诉讼法: sù sòng fǎ
开山: kāi shān
国耻: guó chǐ
want: w a n t
统计组: tǒng jì zǔ
出版商: chū bǎn shāng
奶茶: nǎi chá
人类学: rén lèi xué
错误: cuò wù
皮曙初: pí shǔ chū
悲剧: bēi jù
减薪: jiǎn xīn
后患: hòu huàn
林文程: lín wén chéng
归来: guī lái
开张: kāi zhāng
贺兰: hè lán
农历: nóng lì
李远哲: lǐ yuǎn zhé
配音: pèi yīn
天歌牌: tiān gē pái
外宾: wài bīn
爸爸: bà bà
公开赛: gōng kāi sài
开心: kāi xīn
阵营: zhèn yíng
刘欣怡: liú xīn yí
升迁: shēng qiān
外嫁: wài jià
近因: jìn yīn
尤·凯基: yóu · kǎi jī
十二亿: shí èr yì
集群: jí qún
外婆: wài pó
开店: kāi diàn
2.72: 2 . 7 2
开庭: kāi tíng
筹组: chóu zǔ
公关费: gōng guān fèi
刘义: liú yì
开外: kāi wài
郑永国: zhèng yǒng guó
天下: tiān xià
编辑: biān jí
闭口: bì kǒu
张老师: zhāng lǎo shī
公视: gōng shì
镇定: zhèn dìng
德商: dé shāng
开始: kāi shǐ
截然: jié rán
美工组: měi gōng zǔ
原则性: yuán zé xìng
筹码: chóu mǎ
带进: dài jìn
图书馆组: tú shū guǎn zǔ
竞鸣: jìng míng
天使: tiān shǐ
始自: shǐ zì
８５％: ８ ５ ％
船舰: chuán jiàn
外岛: wài dǎo
氨伦: ān lún
亚杰布莱: yà jié bù lái
船舶: chuán bó
战败: zhàn bài
飞痰: fēi tán
外层: wài céng
浑然: hún rán
Ｃｈａｒｌｅｓ: Ｃ ｈ ａ ｒ ｌ ｅ ｓ
国营: guó yíng
另类: lìng lèi
配送: pèi sòng
五笔: wǔ bǐ
标准箱: biāo zhǔn xiāng
吕秀莲: lǚ xiù lián
后来: hòu lái
刑责: xíng zé
安玻: ān bō
十五日: shí wǔ rì
保管: bǎo guǎn
诉讼案: sù sòng àn
后撤: hòu chè
窠臼: kē jiù
外快: wài kuài
荣恒: róng héng
雾社: wù shè
江门: jiāng mén
荣总: róng zǒng
茅庐: máo lú
真品: zhēn pǐn
深深: shēn shēn
开学: kāi xué
胚型: pēi xíng
公证: gōng zhèng
公诉: gōng sù
岸线: àn xiàn
外形: wài xíng
四十多亿: sì shí duō yì
纽带: niǔ dài
滚滚: gǔn gǔn
亚军: yà jūn
公认: gōng rèn
９３２０．９８: ９ ３ ２ ０ ． ９ ８
商学院: shāng xué yuàn
斩获: zhǎn huò
深沉: shēn chén
悲哀: bēi āi
书法: shū fǎ
安然: ān rán
榉木: jǔ mù
带走: dài zǒu
带起: dài qǐ
水晶座: shuǐ jīng zuò
深水: shēn shuǐ
role: r o l e
薛晓岚: xuē xiǎo lán
筹画: chóu huà
举世瞩目: jǔ shì zhǔ mù
外出: wài chū
让国: ràng guó
毕业自: bì yè zì
农妇: nóng fù
诺贝尔: nuò bèi ěr
安全性: ān quán xìng
农奴: nóng nú
多米: duō mǐ
减轻: jiǎn qīng
My: M y
效用: xiào yòng
困倦: kùn juàn
电镀: diàn dù
真实: zhēn shí
书报: shū bào
开启: kāi qǐ
笔锋: bǐ fēng
安置: ān zhì
保真: bǎo zhēn
人类史: rén lèi shǐ
奉命: fèng mìng
公营: gōng yíng
我军: wǒ jūn
圆满: yuán mǎn
宋健: sòng jiàn
周晓梅: zhōu xiǎo méi
李国修: lǐ guó xiū
壁垒: bì lěi
陈特安: chén tè ān
李亚彪: lǐ yà biāo
剪开: jiǎn kāi
贫者: pín zhě
剪彩: jiǎn cǎi
外借: wài jiè
世锦赛: shì jǐn sài
外债: wài zhài
──: ─ ─
Chuoshui: C h u o s h u i
外口: wài kǒu
急速: jí sù
缘起: yuán qǐ
船货: chuán huò
夺权: duó quán
改扩建: gǎi kuò jiàn
荣泽: róng zé
距今: jù jīn
裁撤: cái chè
农学: nóng xué
吉祥物: jí xiáng wù
胡元辉: hú yuán huī
纸品: zhǐ pǐn
盲点: máng diǎn
楼宇: lóu yǔ
汇编: huì biān
竞速: jìng sù
筹资者: chóu zī zhě
效益: xiào yì
竞选: jìng xuǎn
稚嫩: zhì nèn
训练班: xùn liàn bān
深情: shēn qíng
义务兵: yì wù bīng
外力: wài lì
History: H i s t o r y
外加: wài jiā
外务: wài wù
孔林: kǒng lín
外劳: wài láo
世界: shì jiè
６３９: ６ ３ ９
张循海: zhāng xún hǎi
编者: biān zhě
密布: mì bù
专用: zhuān yòng
开国: kāi guó
初加工: chū jiā gōng
加热器: jiā rè qì
菜肴: cài yáo
开元: kāi yuán
晶莹: jīng yíng
Akungtien: A k u n g t i e n
畅快: chàng kuài
升腾: shēng téng
开关: kāi guān
欢颜: huān yán
进京: jìn jīng
艺文: yì wén
外商: wài shāng
第三二二: dì sān èr èr
裁抑: cái yì
国货: guó huò
楚天: chǔ tiān
犒赏: kào shǎng
盲目: máng mù
职责: zhí zé
沐浴: mù yù
马铃薯: mǎ líng shǔ
郑黎: zhèng lí
揉成: róu chéng
公职: gōng zhí
周三: zhōu sān
配额: pèi é
五十三: wǔ shí sān
三十三: sān shí sān
真心: zhēn xīn
旭日: xù rì
建材局: jiàn cái jú
碾玉: niǎn yù
五十亿: wǔ shí yì
欧巴桑们: ōu bā sāng men
周五: zhōu wǔ
五十二: wǔ shí èr
势必: shì bì
三十二: sān shí èr
马永新: mǎ yǒng xīn
外向: wài xiàng
今日报: jīn rì bào
三十五: sān shí wǔ
即使: jí shǐ
三十亿: sān shí yì
勇敢: yǒng gǎn
五点: wǔ diǎn
外城: wài chéng
伐木: fá mù
养鲍: yǎng bào
密宗: mì zōng
外型: wài xíng
苏宏文: sū hóng wén
菊花: jú huā
电算: diàn suàn
多穷: duō qióng
阳谋: yáng móu
开口: kāi kǒu
院所: yuàn suǒ
外在: wài zài
四十亿: sì shí yì
标准煤: biāo zhǔn méi
四十五: sì shí wǔ
外围: wài wéi
安祥: ān xiáng
外国: wài guó
四十二: sì shí èr
报复性: bào fù xìng
让出: ràng chū
唐人街: táng rén jiē
苏志诚: sū zhì chéng
十日: shí rì
挂毯: guà tǎn
十时: shí shí
真巧: zhēn qiǎo
４００: ４ ０ ０
开办: kāi bàn
开动: kāi dòng
刘忆如: liú yì rú
四十三: sì shí sān
五亿多: wǔ yì duō
圆桌: yuán zhuō
普世: pǔ shì
海鸥轮: hǎi ōu lún
物理: wù lǐ
保湿: bǎo shī
安普: ān pǔ
天威: tiān wēi
二胡: èr hú
根植: gēn zhí
水口村: shuǐ kǒu cūn
天安门: tiān ān mén
贴满: tiē mǎn
194: 1 9 4
牺牲: xī shēng
安曼: ān màn
死者: sǐ zhě
普兰: pǔ lán
三民乡: sān mín xiāng
国酒: guó jiǔ
周到: zhōu dào
锺荣吉: zhōng róng jí
进口: jìn kǒu
剧协: jù xié
多时: duō shí
候选人: hòu xuǎn rén
根根: gēn gēn
刘锦云: liú jǐn yún
交易日: jiāo yì rì
早自习: zǎo zì xí
汇整: huì zhěng
诊断: zhěn duàn
舞蹈界: wǔ dǎo jiè
两点: liǎng diǎn
兢兢业业: jīng jīng yè yè
日日夜夜: rì rì yè yè
剧变: jù biàn
改嫁: gǎi jià
普及: pǔ jí
佐证: zuǒ zhèng
天堂: tiān táng
周全: zhōu quán
仪器: yí qì
周公: zhōu gōng
深秋: shēn qiū
挂盘: guà pán
带领: dài lǐng
船闸: chuán zhá
补偿: bǔ cháng
保泰: bǎo tài
养老: yǎng lǎo
绫线: líng xiàn
二十三点二亿: èr shí sān diǎn èr yì
索珠乡: suǒ zhū xiāng
天天: tiān tiān
开业: kāi yè
陈凤馨: chén fèng xīn
进出: jìn chū
进军: jìn jūn
77.94: 7 7 . 9 4
学堂: xué táng
建设者们: jiàn shè zhě men
起飞: qǐ fēi
圆球: yuán qiú
李贺普: lǐ hè pǔ
补充: bǔ chōng
幽幽艳艳: yōu yōu yàn yàn
１３１: １ ３ １
进入: jìn rù
迹象: jī xiàng
坦荡: tǎn dàng
嫌隙: xián xì
威胁: wēi xié
细心: xì xīn
鲍·利佐: bào · lì zuǒ
小镇: xiǎo zhèn
柔情: róu qíng
近海: jìn hǎi
哲理: zhé lǐ
花型: huā xíng
国门: guó mén
纵线: zòng xiàn
兼负: jiān fù
田径界: tián jìng jiè
16MbD-RAM: 1 6 M b D - R A M
欢聚: huān jù
公馆: gōng guǎn
检视法: jiǎn shì fǎ
公馀: gōng yú
户外: hù wài
证交所: zhèng jiāo suǒ
138.83: 1 3 8 . 8 3
天弓: tiān gōng
公顷: gōng qǐng
ＣＩＰＭ: Ｃ Ｉ Ｐ Ｍ
96.54: 9 6 . 5 4
31: 3 1
30: 3 0
36: 3 6
口腹: kǒu fù
三十四: sān shí sì
欢腾: huān téng
欧元国: ōu yuán guó
养蜂: yǎng fēng
周围: zhōu wéi
五十四: wǔ shí sì
２６６: ２ ６ ６
剧型: jù xíng
补品: bǔ pǐn
安息: ān xī
竞赛: jìng sài
永丰馀: yǒng fēng yú
ON: O N
OK: O K
外侨: wài qiáo
端祥: duān xiáng
外侮: wài wǔ
局势: jú shì
多所: duō suǒ
诊所: zhěn suǒ
棉花: mián huā
汇报: huì bào
物流: wù liú
深紫: shēn zǐ
原订: yuán dìng
外企: wài qǐ
幻影: huàn yǐng
乱影书: luàn yǐng shū
挂牌: guà pái
幻彩: huàn cǎi
五桥: wǔ qiáo
外伤: wài shāng
７００: ７ ０ ０
交易所: jiāo yì suǒ
桑普多利亚队: sāng pǔ duō lì yà duì
安全网: ān quán wǎng
盲流: máng liú
安慰: ān wèi
审美: shěn měi
肝病: gān bìng
宋人: sòng rén
外交: wài jiāo
四十四: sì shí sì
Tachia: T a c h i a
外人: wài rén
学习型: xué xí xíng
国防: guó fáng
婚生: hūn shēng
杨建武: yáng jiàn wǔ
小集: xiǎo jí
减退: jiǎn tuì
减速: jiǎn sù
后生: hòu shēng
盐城: yán chéng
国际: guó jì
凯基: kǎi jī
根源: gēn yuán
升锚: shēng máo
亚协: yà xié
沛然: pèi rán
—－: — －
第四: dì sì
天剑: tiān jiàn
天生: tiān shēng
竖起: shù qǐ
四十多: sì shí duō
剪下: jiǎn xià
截流: jié liú
湖面: hú miàn
滚烫: gǔn tàng
国际村: guó jì cūn
周密: zhōu mì
7.53: 7 . 5 3
静冈县: jìng gāng xiàn
兼职: jiān zhí
张钦宗: zhāng qīn zōng
连江镇: lián jiāng zhèn
进宝: jìn bǎo
亚东: yà dōng
汇流: huì liú
缓缓: huǎn huǎn
释字: shì zì
考选: kǎo xuǎn
９８５: ９ ８ ５
０．６８: ０ ． ６ ８
揉皱: róu zhòu
匆忙: cōng máng
谈话: tán huà
小额: xiǎo é
理财热: lǐ cái rè
安江: ān jiāng
五十多: wǔ shí duō
十点: shí diǎn
Ｗｉｌｓｏｎ: Ｗ ｉ ｌ ｓ ｏ ｎ
安民: ān mín
出版人: chū bǎn rén
进境: jìn jìng
三十多: sān shí duō
小鬈: xiǎo quán
ＮＥＢ: Ｎ Ｅ Ｂ
编配: biān pèi
仲裁: zhòng cái
维杰辛: wéi jié xīn
出版业: chū bǎn yè
宗旨: zōng zhǐ
评定: píng dìng
口述: kǒu shù
死讯: sǐ xùn
安海: ān hǎi
炉灶: lú zào
营生: yíng shēng
五时: wǔ shí
辅导班: fǔ dǎo bān
撷收: xié shōu
五日: wǔ rì
颜延龄: yán yán líng
坦诚: tǎn chéng
世新: shì xīn
集材: jí cái
１４００亿: １ ４ ０ ０ yì
27.20: 2 7 . 2 0
珊瑚礁: shān hú jiāo
集权: jí quán
版权: bǎn quán
标准日: biāo zhǔn rì
进奶: jìn nǎi
归纳: guī nà
艰深: jiān shēn
献出: xiàn chū
1.36: 1 . 3 6
rainbows: r a i n b o w s
ＩＳＯ: Ｉ Ｓ Ｏ
笔者: bǐ zhě
婚纱: hūn shā
后续: hòu xù
情资: qíng zī
后继: hòu jì
起音: qǐ yīn
理财界: lǐ cái jiè
口袋: kǒu dài
欣然: xīn rán
审理: shěn lǐ
五成: wǔ chéng
悲伤: bēi shāng
PC: P C
缎面绣: duàn miàn xiù
讥笑: jī xiào
近日: jìn rì
如流: rú liú
带队: dài duì
保护: bǎo hù
猛力: měng lì
坚固: jiān gù
手笔: shǒu bǐ
保持: bǎo chí
谋生: móu shēng
OECD: O E C D
２０日: ２ ０ rì
巴西队: bā xī duì
第十: dì shí
周延: zhōu yán
普尔: pǔ ěr
躁动: zào dòng
１０００多: １ ０ ０ ０ duō
Macaense: M a c a e n s e
1.23: 1 . 2 3
配股权: pèi gǔ quán
萝丝: luó sī
农保: nóng bǎo
顾问: gù wèn
天后: tiān hòu
口岸关: kǒu àn guān
天命: tiān mìng
拿起: ná qǐ
拿走: ná zǒu
近来: jìn lái
进展: jìn zhǎn
书画: shū huà
实业界: shí yè jiè
截止: jié zhǐ
书生: shū shēng
杨锦聪: yáng jǐn cōng
集成: jí chéng
十四日: shí sì rì
贴息: tiē xī
蜜饯: mì jiàn
口试: kǒu shì
水脑: shuǐ nǎo
编钟: biān zhōng
谈起: tán qǐ
楼下: lóu xià
屡屡: lǚ lǚ
须根: xū gēn
五专: wǔ zhuān
梁鸿细: liáng hóng xì
挤进: jǐ jìn
周岁: zhōu suì
小麦: xiǎo mài
农业: nóng yè
１５日: １ ５ rì
饼店: bǐng diàn
绅士: shēn shì
at: a t
多哥: duō gē
营业: yíng yè
农产: nóng chǎn
显贵: xiǎn guì
环视: huán shì
煤矿: méi kuàng
误判: wù pàn
杨世缄: yáng shì jiān
仓储: cāng chǔ
布尔克: bù ěr kè
环衬: huán chèn
普惠: pǔ huì
拟定: nǐ dìng
贴心: tiē xīn
铁饭碗: tiě fàn wǎn
1991: 1 9 9 1
普及面: pǔ jí miàn
1994: 1 9 9 4
1996: 1 9 9 6
1999: 1 9 9 9
２０多: ２ ０ duō
快闪: kuài shǎn
４８０: ４ ８ ０
周报: zhōu bào
安基: ān jī
乒乓球: pīng pāng qiú
出拳: chū quán
出版界: chū bǎn jiè
联防: lián fáng
五彩: wǔ cǎi
跷课: qiāo kè
决议: jué yì
交易商: jiāo yì shāng
虽然: suī rán
备案: bèi àn
多国: duō guó
四湖乡: sì hú xiāng
效忠: xiào zhōng
陈敏雄: chén mǐn xióng
困窘: kùn jiǒng
开罗: kāi luó
Ｐ＆Ｇ: Ｐ ＆ Ｇ
KenMadsen: K e n M a d s e n
Ｎature: Ｎ a t u r e
环评: huán píng
收费: shōu fèi
国统纲领: guó tǒng gāng lǐng
二二四: èr èr sì
剧情: jù qíng
杨国祯: yáng guó zhēn
文艺界: wén yì jiè
煤球: méi qiú
计算: jì suàn
统计局: tǒng jì jú
鸿沟: hóng gōu
额外: é wài
３日: ３ rì
直拨网: zhí bō wǎng
筹建: chóu jiàn
０．１５: ０ ． １ ５
十二: shí èr
统计学: tǒng jì xué
十五: shí wǔ
贺电: hè diàn
民进党: mín jìn dǎng
林义雄: lín yì xióng
筹备: chóu bèi
十亿: shí yì
缀饰: zhuì shì
十三: shí sān
盈盈: yíng yíng
叙述: xù shù
农田: nóng tián
怡富: yí fù
农用: nóng yòng
嘻闹: xī nào
架起: jià qǐ
保存: bǎo cún
严肃性: yán sù xìng
孰先孰後: shú xiān shú hòu
闯入: chuǎng rù
汇入: huì rù
闯关: chuǎng guān
深业: shēn yè
多元: duō yuán
保密: bǎo mì
纸箱: zhǐ xiāng
小班制: xiǎo bān zhì
进来: jìn lái
保定: bǎo dìng
保安: bǎo ān
第５３: dì ５ ３
汇出: huì chū
十佳: shí jiā
准确性: zhǔn què xìng
辛庆忌: xīn qìng jì
悲痛: bēi tòng
木质: mù zhì
天河: tiān hé
出版物: chū bǎn wù
真理: zhēn lǐ
三十日: sān shí rì
开篇: kāi piān
具具: jù jù
多利: duō lì
孤雏: gū chú
谢辛: xiè xīn
决赛: jué sài
到访: dào fǎng
多变: duō biàn
２２００亿: ２ ２ ０ ０ yì
天津: tiān jīn
陈健豪: chén jiàn háo
安养: ān yǎng
浑厚: hún hòu
安全: ān quán
环踞: huán jù
悍然: hàn rán
联邦: lián bāng
手续费: shǒu xù fèi
即时: jí shí
凯松: kǎi sōng
风情画: fēng qíng huà
煤炭: méi tàn
保姆: bǎo mǔ
天涯: tiān yá
楼盘: lóu pán
缘自: yuán zì
ㄅㄆㄇㄈ: ㄅ ㄆ ㄇ ㄈ
开端: kāi duān
四十二点五: sì shí èr diǎn wǔ
棒球: bàng qiú
两千多: liǎng qiān duō
十二日: shí èr rì
贺礼: hè lǐ
十二时: shí èr shí
侮辱: wǔ rǔ
座谈: zuò tán
闻兆祥: wén zhào xiáng
备战: bèi zhàn
史美泗: shǐ měi sì
颠覆: diān fù
五四: wǔ sì
引领: yǐn lǐng
盲勇: máng yǒng
修泽兰: xiū zé lán
张荣恭: zhāng róng gōng
保国: bǎo guó
板荡: bǎn dàng
黄廷生: huáng tíng shēng
周毅: zhōu yì
摘下: zhāi xià
虚构: xū gòu
弈成: yì chéng
幻想: huàn xiǎng
设定费: shè dìng fèi
物力: wù lì
关闸: guān zhá
人民军: rén mín jūn
关门: guān mén
关闭: guān bì
洛城镇: luò chéng zhèn
铼德: lái dé
统计图: tǒng jì tú
安心: ān xīn
人民党: rén mín dǎng
关键: guān jiàn
保垒: bǎo lěi
消费品: xiāo fèi pǐn
忠义: zhōng yì
巴伦西亚: bā lún xī yà
标准型: biāo zhǔn xíng
开瓶: kāi píng
亚纲: yà gāng
农林厅: nóng lín tīng
版图: bǎn tú
胚株: pēi zhū
汰换: tài huàn
出版组: chū bǎn zǔ
西海岸: xī hǎi àn
３９: ３ ９
３８: ３ ８
３３: ３ ３
３２: ３ ２
３１: ３ １
３０: ３ ０
３６: ３ ６
３５: ３ ５
３４: ３ ４
近千: jìn qiān
近午: jìn wǔ
特首: tè shǒu
磁铁: cí tiě
截弯: jié wān
归侨: guī qiáo
Eric: E r i c
阁揆: gé kuí
归乡: guī xiāng
萨瑟兰: sà sè lán
赵功民: zhào gōng mín
多彩: duō cǎi
开盘: kāi pán
后人: hòu rén
carnivalesque: c a r n i v a l e s q u e
学习法: xué xí fǎ
坡峦: pō luán
后代: hòu dài
虚拟: xū nǐ
佩尔森: pèi ěr sēn
李成玉: lǐ chéng yù
断垣残壁: duàn yuán cán bì
吊诡: diào guǐ
外界: wài jiè
专线: zhuān xiàn
漠视: mò shì
朋友: péng yǒu
戴仁寿: dài rén shòu
秀出: xiù chū
对面: duì miàn
义卖: yì mài
泳装: yǒng zhuāng
粗苯: cū běn
外电: wài diàn
宋瓷: sòng cí
鲨鱼: shā yú
姑娘: gū niáng
筹借: chóu jiè
蓄谋: xù móu
１３５０: １ ３ ５ ０
歧途: qí tú
GNP: G N P
计画: jì huà
对阵: duì zhèn
９．５０: ９ ． ５ ０
安定: ān dìng
出版社: chū bǎn shè
密码: mì mǎ
ＣＯＢＯＬ: Ｃ Ｏ Ｂ Ｏ Ｌ
多多: duō duō
Ｆ１－ＣＲ: Ｆ １ － Ｃ Ｒ
狮泉河: shī quán hé
五千: wǔ qiān
五十: wǔ shí
张衡: zhāng héng
保健: bǎo jiàn
36.04: 3 6 . 0 4
ＥＶＰＥＣ: Ｅ Ｖ Ｐ Ｅ Ｃ
６０００亿: ６ ０ ０ ０ yì
保值: bǎo zhí
维新: wéi xīn
记忆力: jì yì lì
具备: jù bèi
希冀: xī jì
对错: duì cuò
十五亿: shí wǔ yì
按照: àn zhào
３５５·０２: ３ ５ ５ · ０ ２
叛逆: pàn nì
密笈: mì jí
姑姑: gū gū
哲人: zhé rén
时髦: shí máo
多寡: duō guǎ
保养: bǎo yǎng
办起: bàn qǐ
保全: bǎo quán
效力: xiào lì
know-how: k n o w - h o w
吊装: diào zhuāng
贴出: tiē chū
忽视: hū shì
16:15:59: 1 6 : 1 5 : 5 9
录下: lù xià
筹办: chóu bàn
天文: tiān wén
天时: tiān shí
户户: hù hù
心痛: xīn tòng
恢复性: huī fù xìng
３２１ＳＶ: ３ ２ １ Ｓ Ｖ
美国人: měi guó rén
五亿: wǔ yì
世代: shì dài
外交官: wài jiāo guān
铭记: míng jì
７４．５亿: ７ ４ ． ５ yì
五代: wǔ dài
对话: duì huà
世人: shì rén
勇士: yǒng shì
圆圆: yuán yuán
林浊水: lín zhuó shuǐ
普照: pǔ zhào
8865: 8 8 6 5
保佑: bǎo yòu
保住: bǎo zhù
环顾: huán gù
梦魇: mèng yǎn
献策: xiàn cè
帮衬: bāng chèn
录像: lù xiàng
三点四: sān diǎn sì
IBM: I B M
关贸: guān mào
勇夺: yǒng duó
协办: xié bàn
后卫: hòu wèi
文史哲: wén shǐ zhé
天篷: tiān péng
58.84: 5 8 . 8 4
十字: shí zì
字汇: zì huì
河滨: hé bīn
物理学: wù lǐ xué
贡献: gòng xiàn
镇海: zhèn hǎi
孔府: kǒng fǔ
孔庙: kǒng miào
深夜: shēn yè
吊销: diào xiāo
悲愤: bēi fèn
美国史: měi guó shǐ
剧烈: jù liè
开玩笑: kāi wán xiào
审定: shěn dìng
镇江: zhèn jiāng
悲情: bēi qíng
１８．７亿: １ ８ ． ７ yì
让渡: ràng dù
归国: guī guó
录制: lù zhì
７７: ７ ７
７５: ７ ５
归因: guī yīn
７２: ７ ２
７０: ７ ０
十多: shí duō
７９: ７ ９
农牧业: nóng mù yè
联营: lián yíng
农户: nóng hù
做起: zuò qǐ
社评: shè píng
对街: duì jiē
来自: lái zì
安全局: ān quán jú
院士: yuàn shì
残破: cán pò
旭峰: xù fēng
态势: tài shì
外流: wài liú
天线: tiān xiàn
汉文帝: hàn wén dì
歧视: qí shì
外海: wài hǎi
卫铁民: wèi tiě mín
瘦瘦: shòu shòu
微多孔: wēi duō kǒng
挚爱: zhì ài
书店: shū diàn
夙孚: sù fú
缓急: huǎn jí
69.74: 6 9 . 7 4
外求: wài qiú
外汇: wài huì
聋人: lóng rén
十四亿: shí sì yì
富集: fù jí
愈来愈: yù lái yù
法国队: fǎ guó duì
让步: ràng bù
物业: wù yè
壁毯: bì tǎn
真宗: zhēn zōng
农林: nóng lín
EXCEL: E X C E L
材林: cái lín
安全帽: ān quán mào
协商: xié shāng
天籁: tiān lài
农村: nóng cūn
归口: guī kǒu
谴责: qiǎn zé
忠党: zhōng dǎng
苏玉麒: sū yù qí
SOUND: S O U N D
１７１６亿: １ ７ １ ６ yì
外滩: wài tān
如茵: rú yīn
邱加利: qiū jiā lì
美日商: měi rì shāng
近乎: jìn hū
灭蚊: miè wén
违规: wéi guī
五点三二亿: wǔ diǎn sān èr yì
对谈: duì tán
对象: duì xiàng
近代: jìn dài
荣况: róng kuàng
归功: guī gōng
党代表: dǎng dài biǎo
书局: shū jú
书屋: shū wū
联考: lián kǎo
困惑: kùn huò
简报室: jiǎn bào shì
深厚: shēn hòu
仓库: cāng kù
书史: shū shǐ
婚嫁: hūn jià
购货: gòu huò
贝类: bèi lèi
刘文玉: liú wén yù
进程: jìn chéng
突来: tū lái
圆形: yuán xíng
卫惠林: wèi huì lín
隐隐: yǐn yǐn
纸板: zhǐ bǎn
树莓: shù méi
外患: wài huàn
安·马尔: ān · mǎ ěr
壕沟: háo gōu
十千: shí qiān
利国伟: lì guó wěi
凸显: tū xiǎn
幻灭: huàn miè
郑海泉: zhèng hǎi quán
RAM: R A M
缠住: chán zhù
按时: àn shí
滚到: gǔn dào
天灾: tiān zāi
起舞: qǐ wǔ
多云: duō yún
多京: duō jīng
１.８２5亿: １ . ８ ２ 5 yì
开来: kāi lái
乱象: luàn xiàng
灿烂: càn làn
亚洲: yà zhōu
挂帅: guà shuài
审判: shěn pàn
多久: duō jiǔ
１８０: １ ８ ０
挂帐: guà zhàng
纽扣: niǔ kòu
１８５: １ ８ ５
四成多: sì chéng duō
猛男: měng nán
联赛: lián sài
闪闪: shǎn shǎn
仁人志士: rén rén zhì shì
深入: shēn rù
引诱: yǐn yòu
天然: tiān rán
哲学: zhé xué
版画: bǎn huà
锋利: fēng lì
营商: yíng shāng
婚姻: hūn yīn
樟树: zhāng shù
后备: hòu bèi
建议: jiàn yì
卢晶: lú jīng
圆山: yuán shān
对联: duì lián
营利: yíng lì
宜进: yí jìn
忠实: zhōng shí
端午: duān wǔ
自律: zì lǜ
圆寂: yuán jì
十四: shí sì
Levine: L e v i n e
盈满: yíng mǎn
关联: guān lián
2.45: 2 . 4 5
丹顶鹤: dān dǐng hè
盈溢: yíng yì
建起: jiàn qǐ
天真: tiān zhēn
来袭: lái xí
58.1: 5 8 . 1
趋势图: qū shì tú
慧星: huì xīng
８５亿: ８ ５ yì
引起: yǐn qǐ
钱穆: qián mù
轮船: lún chuán
木雕: mù diāo
引资: yǐn zī
http: h t t p
农民: nóng mín
营口: yíng kǒu
协建: xié jiàn
刘加坤: liú jiā kūn
企管所: qǐ guǎn suǒ
49: 4 9
47: 4 7
夜晚: yè wǎn
开挖: kāi wā
李国宝: lǐ guó bǎo
国境线: guó jìng xiàn
洛克希德: luò kè xī dé
来访: lái fǎng
兰阳: lán yáng
邦谊: bāng yì
６．５８: ６ ． ５ ８
理财型: lǐ cái xíng
普罗: pǔ luó
外来: wài lái
水湄社: shuǐ méi shè
橡皮: xiàng pí
书商: shū shāng
灭迹: miè jī
凯缇: kǎi tí
开战: kāi zhàn
粗鄙: cū bǐ
闪速: shǎn sù
引进: yǐn jìn
开户: kāi hù
笙歌: shēng gē
营养: yíng yǎng
胡书君: hú shū jūn
猛烈: měng liè
１６７９０亿: １ ６ ７ ９ ０ yì
简彰佑: jiǎn zhāng yòu
裁军: cái jūn
怪人: guài rén
裁决: cái jué
Pommeraye: P o m m e r a y e
晨曦: chén xī
题词: tí cí
村务: cūn wù
确保: què bǎo
Bailey: B a i l e y
交货值: jiāo huò zhí
购入: gòu rù
输入国: shū rù guó
加进: jiā jìn
布吉纳法索: bù jí nà fǎ suǒ
黄勇贤: huáng yǒng xián
专户: zhuān hù
设备费: shè bèi fèi
简又新: jiǎn yòu xīn
绘图: huì tú
陈建国: chén jiàn guó
虔敬: qián jìng
全力: quán lì
鼻孔: bí kǒng
终端: zhōng duān
布国: bù guó
马玉山: mǎ yù shān
绝决: jué jué
商务: shāng wù
先天: xiān tiān
向下: xiàng xià
闹酒: nào jiǔ
审视: shěn shì
梁山: liáng shān
标签: biāo qiān
产销: chǎn xiāo
第二十: dì èr shí
憨厚: hān hòu
先秦: xiān qín
晋江: jìn jiāng
陈怡芬: chén yí fēn
晒出: shài chū
陈元: chén yuán
五点三亿: wǔ diǎn sān yì
所在: suǒ zài
真实性: zhēn shí xìng
小两口: xiǎo liǎng kǒu
公安厅: gōng ān tīng
先导: xiān dǎo
自序: zì xù
泰森: tài sēn
务农: wù nóng
薪水: xīn shuǐ
钜额: jù é
工总: gōng zǒng
蹉跎: cuō tuó
定时: dìng shí
泱泱: yāng yāng
剩馀: shèng yú
使然: shǐ rán
流程: liú chéng
营收: yíng shōu
黄文忠: huáng wén zhōng
加贺: jiā hè
第五二○: dì wǔ èr ○
自设: zì shè
党产: dǎng chǎn
装船: zhuāng chuán
全全: quán quán
原住民: yuán zhù mín
设法: shè fǎ
劳资战: láo zī zhàn
特殊: tè shū
黄文庆: huáng wén qìng
请安: qǐng ān
营销额: yíng xiāo é
时段: shí duàn
原产国: yuán chǎn guó
苏军: sū jūn
徒刑: tú xíng
张德聪: zhāng dé cōng
眺望: tiào wàng
加计: jiā jì
加设: jiā shè
４８００: ４ ８ ０ ０
瞬息: shùn xī
６６５: ６ ６ ５
６６１: ６ ６ １
林秀伟: lín xiù wěi
危殆: wēi dài
林焕庚: lín huàn gēng
二点二亿: èr diǎn èr yì
快讯: kuài xùn
绘制: huì zhì
１４１３亿: １ ４ １ ３ yì
陈吉: chén jí
悲壮: bēi zhuàng
Erhjen: E r h j e n
黄保欣: huáng bǎo xīn
徐徐: xú xú
击球: jī qiú
海滨: hǎi bīn
暂停: zàn tíng
摔交: shuāi jiāo
撤消: chè xiāo
６亿: ６ yì
濒危: bīn wēi
门户: mén hù
伍泽元: wǔ zé yuán
商城: shāng chéng
煮煮: zhǔ zhǔ
细腻: xì nì
代表制: dài biǎo zhì
海湾: hǎi wān
泪水: lèi shuǐ
张翼飞: zhāng yì fēi
３６４: ３ ６ ４
舞集: wǔ jí
微醺: wēi xūn
布偶: bù ǒu
先後: xiān hòu
CoolBid: C o o l B i d
１８００多: １ ８ ０ ０ duō
愈形: yù xíng
消逝: xiāo shì
商品: shāng pǐn
使用: shǐ yòng
收敛水: shōu liǎn shuǐ
军人: jūn rén
殿试: diàn shì
加入者: jiā rù zhě
再生: zài shēng
输入值: shū rù zhí
轻工业品: qīng gōng yè pǐn
永恒: yǒng héng
流美: liú měi
海河: hǎi hé
迅猛: xùn měng
工整: gōng zhěng
历程: lì chéng
加装: jiā zhuāng
珠宝: zhū bǎo
扼杀: è shā
管辖: guǎn xiá
专攻: zhuān gōng
视频: shì pín
小黄鱼: xiǎo huáng yú
吉林: jí lín
蓟县: jì xiàn
５３: ５ ３
仓储业: cāng chǔ yè
徐州: xú zhōu
性情: xìng qíng
工日: gōng rì
下班: xià bān
海水: hǎi shuǐ
鹅銮鼻: é luán bí
驱策: qū cè
Techi: T e c h i
残渣: cán zhā
布农: bù nóng
骤然: zhòu rán
特性: tè xìng
买下: mǎi xià
谘询权: zī xún quán
务实: wù shí
悲凄: bēi qī
举起: jǔ qǐ
先决: xiān jué
先兆: xiān zhào
浑象仪: hún xiàng yí
悼念: dào niàn
２７日: ２ ７ rì
故此: gù cǐ
炒菁: chǎo jīng
海报: hǎi bào
马来西亚: mǎ lái xī yà
美浓人: měi nóng rén
师资: shī zī
球具: qiú jù
刘秀: liú xiù
请入: qǐng rù
杯盘: bēi pán
鹰嘴: yīng zuǐ
执导: zhí dǎo
140: 1 4 0
商定: shāng dìng
玉林: yù lín
照护: zhào hù
绝境: jué jìng
磁谱仪: cí pǔ yí
布局: bù jú
请到: qǐng dào
梅艳芳: méi yàn fāng
布展: bù zhǎn
专案: zhuān àn
邀宴: yāo yàn
加薪: jiā xīn
柔性: róu xìng
卸下: xiè xià
全盘皆输: quán pán jiē shū
歌坛: gē tán
实质: shí zhì
专栏: zhuān lán
债务: zhài wù
诚实: chéng shí
唤起: huàn qǐ
绝对: jué duì
实践: shí jiàn
汉宣帝: hàn xuān dì
绘就: huì jiù
宵夜: xiāo yè
下级: xià jí
时报: shí bào
左宗棠: zuǒ zōng táng
下线: xià xiàn
终点: zhōng diǎn
唁电: yàn diàn
买断: mǎi duàn
１２日: １ ２ rì
锺沐卿: zhōng mù qīng
嫦娥: cháng é
１２时: １ ２ shí
试点: shì diǎn
COSTCO: C O S T C O
停办: tíng bàn
PVC: P V C
村妇: cūn fù
走来: zǒu lái
１２２１亿: １ ２ ２ １ yì
史克必成: shǐ kè bì chéng
湘乡: xiāng xiāng
竞争者: jìng zhēng zhě
撤换: chè huàn
旧习: jiù xí
200: 2 0 0
２９０·１９: ２ ９ ０ · １ ９
时装剧: shí zhuāng jù
莺歌: yīng gē
Thau: T h a u
先制: xiān zhì
购买力: gòu mǎi lì
出口国: chū kǒu guó
We: W e
垒成: lěi chéng
香肠: xiāng cháng
捡来: jiǎn lái
ＷＢＡ: Ｗ Ｂ Ａ
申请案: shēn qǐng àn
请命: qǐng mìng
务必: wù bì
１０２: １ ０ ２
１００: １ ０ ０
侨领: qiáo lǐng
宫廷: gōng tíng
党外: dǎng wài
悲怆: bēi chuàng
三十五点二亿: sān shí wǔ diǎn èr yì
商店: shāng diàn
静谧: jìng mì
迳自: jìng zì
购屋: gòu wū
欣慰: xīn wèi
时效: shí xiào
进口棉: jìn kǒu mián
16.3: 1 6 . 3
全开: quán kāi
快艇: kuài tǐng
天日: tiān rì
德业: dé yè
时日: shí rì
怒吼: nù hǒu
时时: shí shí
马毓真: mǎ yù zhēn
现状: xiàn zhuàng
２０００: ２ ０ ０ ０
琼山: qióng shān
CD-R: C D - R
开出: kāi chū
先后: xiān hòu
公安局: gōng ān jú
尊荣: zūn róng
商展: shāng zhǎn
孙晓郁: sūn xiǎo yù
天际线: tiān jì xiàn
法新社: fǎ xīn shè
全局: quán jú
ＣＢ: Ｃ Ｂ
ＣＲ: Ｃ Ｒ
２５％: ２ ５ ％
工法: gōng fǎ
２５０: ２ ５ ０
门楼: mén lóu
门楚: mén chǔ
京津塘: jīng jīn táng
举证: jǔ zhèng
沉痛: chén tòng
恭谨: gōng jǐn
危急: wēi jí
楼层: lóu céng
舞龙: wǔ lóng
终生: zhōng shēng
设想: shè xiǎng
４１５亿: ４ １ ５ yì
特权: tè quán
———: — — —
望远镜: wàng yuǎn jìng
境界: jìng jiè
4.41: 4 . 4 1
出口商: chū kǒu shāng
下篇: xià piān
朽烂: xiǔ làn
豪杰: háo jié
滨海: bīn hǎi
张骞: zhāng qiān
国泰民安: guó tài mín ān
８００: ８ ０ ０
灾变: zāi biàn
史学: shǐ xué
陪葬品: péi zàng pǐn
轮替: lún tì
党工: dǎng gōng
９·８７５: ９ · ８ ７ ５
班固: bān gù
勉力: miǎn lì
伸张: shēn zhāng
财险: cái xiǎn
勉励: miǎn lì
史实: shǐ shí
设置: shè zhì
定桩: dìng zhuāng
财阀: cái fá
安西府: ān xī fǔ
５．８: ５ ． ８
消融: xiāo róng
实际: shí jì
终止: zhōng zhǐ
ＥＶＲＥＣ: Ｅ Ｖ Ｒ Ｅ Ｃ
制衡力: zhì héng lì
唱唱: chàng chàng
疏松: shū sōng
残碑: cán bēi
专班: zhuān bān
五十五: wǔ shí wǔ
历法: lì fǎ
特稿: tè gǎo
旧城: jiù chéng
胸围: xiōng wéi
执照: zhí zhào
江永: jiāng yǒng
时程: shí chéng
算起: suàn qǐ
性病: xìng bìng
帐篷: zhàng péng
囚犯: qiú fàn
门生: mén shēng
旧址: jiù zhǐ
到案: dào àn
代表性: dài biǎo xìng
江河: jiāng hé
仕途: shì tú
德军: dé jūn
林茂寅: lín mào yín
李宗懋: lǐ zōng mào
下来: xià lái
现汇: xiàn huì
特等: tè děng
胸径: xiōng jìng
党建: dǎng jiàn
晋级: jìn jí
军官: jūn guān
评出: píng chū
录音带: lù yīn dài
俄文: é wén
贸易性: mào yì xìng
等值: děng zhí
唐飞: táng fēi
持稳: chí wěn
吕亚力: lǚ yà lì
伸展: shēn zhǎn
矿业: kuàng yè
苍生: cāng shēng
确定: què dìng
确实: què shí
军山: jūn shān
卫士: wèi shì
流泪: liú lèi
视讯: shì xùn
催生: cuī shēng
矿产: kuàng chǎn
帛琉: bó liú
德基: dé jī
算计: suàn jì
歌手: gē shǒu
侨联: qiáo lián
流水: liú shuǐ
柔细: róu xì
电话线: diàn huà xiàn
烧制: shāo zhì
原动力: yuán dòng lì
Reservoirs: R e s e r v o i r s
岛民: dǎo mín
Kaviiad: K a v i i a d
向导: xiàng dǎo
糖业: táng yè
冤狱: yuān yù
必然: bì rán
导览: dǎo lǎn
海绵: hǎi mián
朗朗: lǎng lǎng
乔颖: qiáo yǐng
代表权: dài biǎo quán
工矿: gōng kuàng
走私: zǒu sī
向学: xiàng xué
德国: dé guó
帛画: bó huà
军工: jūn gōng
临阵: lín zhèn
1961: 1 9 6 1
录音室: lù yīn shì
消防队: xiāo fáng duì
旧历: jiù lì
特级: tè jí
罐形: guàn xíng
久久: jiǔ jiǔ
１１．６７: １ １ ． ６ ７
78.7: 7 8 . 7
警讯: jǐng xùn
李宏源: lǐ hóng yuán
持续: chí xù
1.51: 1 . 5 1
专电: zhuān diàn
先人: xiān rén
Beijing: B e i j i n g
蛋糕: dàn gāo
暌违: kuí wéi
静静: jìng jìng
ＧＥ: Ｇ Ｅ
１６２７: １ ６ ２ ７
辘轳: lù lú
胡耀邦: hú yào bāng
蛋类: dàn lèi
向外: xiàng wài
implied: i m p l i e d
割喉: gē hóu
奖励: jiǎng lì
张灿洪: zhāng càn hóng
永续: yǒng xù
张贴: zhāng tiē
下水: xià shuǐ
工程: gōng chéng
专程: zhuān chéng
孝孝: xiào xiào
特点: tè diǎn
下泻: xià xiè
专利局: zhuān lì jú
濒临: bīn lín
李銮辉: lǐ luán huī
历时: lì shí
微软: wēi ruǎn
轮渡: lún dù
河段: hé duàn
下海: xià hǎi
翠黛: cuì dài
ＣＥＣ: Ｃ Ｅ Ｃ
烧录: shāo lù
责成: zé chéng
吉祥: jí xiáng
魅影: mèi yǐng
评审: píng shěn
快锅: kuài guō
２亿: ２ yì
张轰: zhāng hōng
张建松: zhāng jiàn sōng
滥用: làn yòng
屠杀: tú shā
诠释: quán shì
ＭＭ: Ｍ Ｍ
历来: lì lái
联姻: lián yīn
双向: shuāng xiàng
现时: xiàn shí
基辅: jī fǔ
击毙: jī bì
快门: kuài mén
储蓄所: chǔ xù suǒ
士农工商: shì nóng gōng shāng
Significance: S i g n i f i c a n c e
评奖: píng jiǎng
互利: hù lì
在职: zài zhí
夙愿: sù yuàn
针对性: zhēn duì xìng
娇娘: jiāo niáng
娇娇: jiāo jiāo
战力: zhàn lì
十二亿多: shí èr yì duō
尸首: shī shǒu
影剧院: yǐng jù yuàn
党国: dǎng guó
五○: wǔ ○
责怪: zé guài
巩固: gǒng gù
岳飞: yuè fēi
轮流: lún liú
力邀: lì yāo
互动: hù dòng
消费: xiāo fèi
心酸: xīn suān
赵新兵: zhào xīn bīng
门类: mén lèi
彼岸: bǐ àn
擦擦: cā cā
军史: jūn shǐ
冬日: dōng rì
叠成: dié chéng
梁静茹: liáng jìng rú
维谦: wéi qiān
下档: xià dàng
１８０多亿: １ ８ ０ duō yì
商业: shāng yè
残疾: cán jí
执业: zhí yè
程颐: chéng yí
德德: dé dé
偶然: ǒu rán
徐仁杰: xú rén jié
商人: shāng rén
现成: xiàn chéng
卫冕: wèi miǎn
下楼: xià lóu
故纸: gù zhǐ
周星驰: zhōu xīng chí
Kishigawa: K i s h i g a w a
１５００: １ ５ ０ ０
张裕: zhāng yù
实验: shí yàn
下榻: xià tà
终极: zhōng jí
宴请: yàn qǐng
玉环: yù huán
到来: dào lái
９·７００: ９ · ７ ０ ０
河流: hé liú
翱翔: áo xiáng
伸出: shēn chū
盆花: pén huā
享用: xiǎng yòng
锺坚: zhōng jiān
新西兰: xīn xī lán
走狗: zǒu gǒu
舞蹈: wǔ dǎo
互补性: hù bǔ xìng
流星: liú xīng
德州: dé zhōu
伸入: shēn rù
韧性: rèn xìng
林业史: lín yè shǐ
认真: rèn zhēn
粤东: yuè dōng
河汊: hé chà
快速: kuài sù
购买: gòu mǎi
公权力: gōng quán lì
到时: dào shí
店面: diàn miàn
照理: zhào lǐ
常住: cháng zhù
盈利性: yíng lì xìng
终日: zhōng rì
倾泻: qīng xiè
河河: hé hé
鸡蛋: jī dàn
刊物: kān wù
产证: chǎn zhèng
加速: jiā sù
四十二亿多: sì shí èr yì duō
贝克尔: bèi kè ěr
睦邻: mù lín
陈烈: chén liè
轮回: lún huí
诚然: chéng rán
向源: xiàng yuán
绝然: jué rán
嘴巴: zuǐ bā
现役: xiàn yì
现形: xiàn xíng
ＡＡ－: Ａ Ａ －
俄国: é guó
河口: hé kǒu
仍旧: réng jiù
击出: jī chū
鼻笛: bí dí
朗文: lǎng wén
马修．连恩: mǎ xiū ． lián ēn
专题: zhuān tí
农渔业: nóng yú yè
产成品: chǎn chéng pǐn
小酒: xiǎo jiǔ
德成: dé chéng
索面: suǒ miàn
欧吉桑们: ōu jí sāng men
７５０: ７ ５ ０
米轨: mǐ guǐ
密集型: mì jí xíng
跃升: yuè shēng
乖乖: guāi guāi
冬忙: dōng máng
显微镜: xiǎn wēi jìng
韩忠学: hán zhōng xué
终审: zhōng shěn
东西: dōng xī
皮肤: pí fū
江山: jiāng shān
总理府: zǒng lǐ fǔ
矿砂: kuàng shā
张汉文: zhāng hàn wén
素质: sù zhì
迈进: mài jìn
下图: xià tú
４００多: ４ ０ ０ duō
４３２７００: ４ ３ ２ ７ ０ ０
攀谈: pān tán
全然: quán rán
走低: zǒu dī
粗劣: cū liè
购物: gòu wù
灾情: zāi qíng
军歌: jūn gē
恐龙: kǒng lóng
争鸣: zhēng míng
专利权: zhuān lì quán
绘画: huì huà
田联: tián lián
歌唱: gē chàng
Ｈ股: Ｈ gǔ
境外: jìng wài
专业者: zhuān yè zhě
朗杰: lǎng jié
迁建: qiān jiàn
林坤钟: lín kūn zhōng
军民: jūn mín
满堂彩: mǎn táng cǎi
到府: dào fǔ
卫检: wèi jiǎn
现存: xiàn cún
叫做: jiào zuò
问世: wèn shì
贸易型: mào yì xíng
歌剧: gē jù
陈瑜: chén yú
点验: diǎn yàn
现实: xiàn shí
悉心: xī xīn
陈瑶: chén yáo
走下坡: zǒu xià pō
轻骑: qīng qí
全盘: quán pán
烧成: shāo chéng
流山: liú shān
崭新: zhǎn xīn
５６％: ５ ６ ％
密特朗: mì tè lǎng
终归: zhōng guī
松辽: sōng liáo
佳话: jiā huà
集水: jí shuǐ
佳评: jiā píng
换装: huàn zhuāng
冬季: dōng jì
岛屿: dǎo yǔ
用途: yòng tú
灵芝: líng zhī
海丰: hǎi fēng
琼瑶: qióng yáo
画面: huà miàn
矿泉水: kuàng quán shuǐ
心连心: xīn lián xīn
季后赛: jì hòu sài
P133: P 1 3 3
艺品: yì pǐn
三成多: sān chéng duō
全球: quán qiú
韩资: hán zī
水性: shuǐ xìng
时下: shí xià
54: 5 4
时代: shí dài
蜗牛: wō niú
51: 5 1
特产: tè chǎn
50: 5 0
9999: 9 9 9 9
52: 5 2
击垮: jī kuǎ
玩耍: wán shuǎ
回忆录: huí yì lù
轮候: lún hòu
德文: dé wén
布点: bù diǎn
轮值: lún zhí
林建元: lín jiàn yuán
15.27: 1 5 . 2 7
徒然: tú rán
商界: shāng jiè
周刊: zhōu kān
倾向: qīng xiàng
下午: xià wǔ
冬天: dōng tiān
５０亿: ５ ０ yì
特使: tè shǐ
RAMBUS: R A M B U S
０６: ０ ６
商用: shāng yòng
迅即: xùn jí
持久: chí jiǔ
１２００: １ ２ ０ ０
３５５·３５: ３ ５ ５ · ３ ５
选在: xuǎn zài
使命: shǐ mìng
０５: ０ ５
吉利: jí lì
仓惶: cāng huáng
俄军: é jūn
五十馀: wǔ shí yú
下山: xià shān
轮廓: lún kuò
海岛型: hǎi dǎo xíng
全程: quán chéng
现在: xiàn zài
松花: sōng huā
现址: xiàn zhǐ
矿物: kuàng wù
自在: zì zài
击败: jī bài
东菱: dōng líng
62.50: 6 2 . 5 0
鲔类: wěi lèi
截止到: jié zhǐ dào
闽江: mǐn jiāng
永久: yǒng jiǔ
先烈: xiān liè
性交: xìng jiāo
设计者: shè jì zhě
连锁: lián suǒ
布置: bù zhì
管理者: guǎn lǐ zhě
湘江: xiāng jiāng
推陈出新: tuī chén chū xīn
向来: xiàng lái
群山: qún shān
沉淀: chén diàn
东芝: dōng zhī
互惠: hù huì
流入: liú rù
锺情: zhōng qíng
江垭: jiāng yā
三成四: sān chéng sì
暂缓: zàn huǎn
擢举: zhuó jǔ
流动: liú dòng
网目: wǎng mù
３８７３．１０: ３ ８ ７ ３ ． １ ０
迁址: qiān zhǐ
龚鹏程: gōng péng chéng
互换: hù huàn
申请书: shēn qǐng shū
卫星: wèi xīng
流利: liú lì
申请人: shēn qǐng rén
骤减: zhòu jiǎn
班汉: bān hàn
F12: F 1 2
悸动: jì dòng
熔炼: róng liàn
东聚: dōng jù
赞美: zàn měi
袭自: xí zì
冶炼: yě liàn
IMF: I M F
流变: liú biàn
商社: shāng shè
谭刚伦: tán gāng lún
境况: jìng kuàng
轩轾: xuān zhì
玩起: wán qǐ
必修: bì xiū
ＩＥＣ: Ｉ Ｅ Ｃ
谢德锡: xiè dé xī
彼此: bǐ cǐ
专书: zhuān shū
球球: qiú qiú
阅历: yuè lì
庙宇: miào yǔ
象征: xiàng zhēng
专业: zhuān yè
迁入: qiān rù
工业: gōng yè
工专: gōng zhuān
薰香: xūn xiāng
流向: liú xiàng
74.64: 7 4 . 6 4
陷阱: xiàn jǐng
美洲: měi zhōu
１００多: １ ０ ０ duō
张建军: zhāng jiàn jūn
工人: gōng rén
６９．９亿: ６ ９ ． ９ yì
故人: gù rén
1980: 1 9 8 0
总则: zǒng zé
陵墓: líng mù
党性: dǎng xìng
聚财: jù cái
江口: jiāng kǒu
现勘: xiàn kān
伸手: shēn shǒu
故乡: gù xiāng
奖杯: jiǎng bēi
直航: zhí háng
进出口权: jìn chū kǒu quán
６日: ６ rì
购置: gòu zhì
谋职: móu zhí
国庆日: guó qìng rì
营养品: yíng yǎng pǐn
绝缘: jué yuán
河川: hé chuān
浙江: zhè jiāng
邱健堂: qiū jiàn táng
现况: xiàn kuàng
出生: chū shēng
阅兵: yuè bīng
擦出: cā chū
选出: xuǎn chū
绝美: jué měi
历史: lì shǐ
美浓: měi nóng
请益: qǐng yì
锺永丰: zhōng yǒng fēng
帛书: bó shū
来访者: lái fǎng zhě
燃香: rán xiāng
唱歌: chàng gē
迁到: qiān dào
志工: zhì gōng
秦俑: qín yǒng
流域: liú yù
马克杯: mǎ kè bēi
Shihmen: S h i h m e n
谶纬: chèn wěi
二点五五亿: èr diǎn wǔ wǔ yì
象山: xiàng shān
恢复: huī fù
９·７８７: ９ · ７ ８ ７
艰钜: jiān jù
标题: biāo tí
河岸: hé àn
灾民: zāi mín
６０多: ６ ０ duō
下定: xià dìng
课辅: kè fǔ
四十点二亿: sì shí diǎn èr yì
蠢蠢欲动: chǔn chǔn yù dòng
陈情: chén qíng
领到: lǐng dào
全成: quán chéng
商战: shāng zhàn
专利: zhuān lì
５０多: ５ ０ duō
球棒: qiú bàng
黄文涛: huáng wén tāo
讨债: tǎo zhài
工务: gōng wù
照实: zhào shí
博物馆: bó wù guǎn
ＤＳＯ: Ｄ Ｓ Ｏ
商报: shāng bào
２１６亿: ２ １ ６ yì
缤纷: bīn fēn
骗购: piàn gòu
专卖: zhuān mài
连贯: lián guàn
工匠: gōng jiàng
２日: ２ rì
布朗: bù lǎng
炒鱿鱼: chǎo yóu yú
诚恳: chéng kěn
滥建: làn jiàn
吉兆: jí zhào
问对: wèn duì
现今: xiàn jīn
聚酯: jù zhǐ
现代: xiàn dài
偶尔: ǒu ěr
哥威迅: gē wēi xùn
诚挚: chéng zhì
碑学: bēi xué
渺小: miǎo xiǎo
玉山: yù shān
陌生人: mò shēng rén
OLED: O L E D
巫奕龙: wū yì lóng
认定: rèn dìng
罗湖关: luó hú guān
海天: hǎi tiān
商情: shāng qíng
走廊: zǒu láng
海外: hǎi wài
残存: cán cún
争辉: zhēng huī
库马尔: kù mǎ ěr
报收: bào shōu
争辩: zhēng biàn
工具: gōng jù
１９９１: １ ９ ９ １
１９９３: １ ９ ９ ３
１９９４: １ ９ ９ ４
１９９７: １ ９ ９ ７
１９９９: １ ９ ９ ９
１９９８: １ ９ ９ ８
多伊彻: duō yī chè
荡漾: dàng yàng
党纲: dǎng gāng
non-no: n o n - n o
党组: dǎng zǔ
领先: lǐng xiān
西隅: xī yú
水晶: shuǐ jīng
讨厌: tǎo yàn
碧海: bì hǎi
Zen-Bio: Z e n - B i o
领军: lǐng jūn
性向: xìng xiàng
工程馆: gōng chéng guǎn
特定: tè dìng
ＤＤ: Ｄ Ｄ
连连: lián lián
囚友: qiú yǒu
轻轻: qīng qīng
性命: xìng mìng
时宜: shí yí
海塘: hǎi táng
海德: hǎi dé
仍然: réng rán
时局: shí jú
胡靖国: hú jìng guó
设定: shè dìng
污染: wū rǎn
飙舞: biāo wǔ
镜饼: jìng bǐng
公鸡: gōng jī
禄口: lù kǒu
李泰临: lǐ tài lín
特展: tè zhǎn
屋宇: wū yǔ
艰辛: jiān xīn
源流: yuán liú
乖孙: guāi sūn
磋商: cuō shāng
泰晤士报: tài wù shì bào
４００亿: ４ ０ ０ yì
四十四点三亿: sì shí sì diǎn sān yì
壮老: zhuàng lǎo
陈旺: chén wàng
柔弱: róu ruò
丰美: fēng měi
公检法: gōng jiǎn fǎ
获奖者: huò jiǎng zhě
先河: xiān hé
故国: gù guó
全权: quán quán
韩商: hán shāng
很多: hěn duō
赈灾: zhèn zāi
直驱: zhí qū
陕西: shǎn xī
先民: xiān mín
旖旎: yǐ nǐ
林焕水: lín huàn shuǐ
陈癸淼: chén guǐ miǎo
流产: liú chǎn
１３７: １ ３ ７
2.15: 2 . 1 5
陈国富: chén guó fù
聚集: jù jí
绝望: jué wàng
刘述卿: liú shù qīng
吕枫: lǚ fēng
球坛: qiú tán
奢侈物: shē chǐ wù
鼻涕: bí tì
纲领: gāng lǐng
愤怒: fèn nù
薰药: xūn yào
山崩: shān bēng
芜湖: wú hú
鲁迅: lǔ xùn
４５: ４ ５
ＭＥＰ: Ｍ Ｅ Ｐ
泰山: tài shān
设备: shè bèi
生产国: shēng chǎn guó
捕捞: bǔ lāo
设奖: shè jiǎng
时序: shí xù
赞扬: zàn yáng
争议: zhēng yì
４１: ４ １
愤慨: fèn kǎi
海岸: hǎi àn
工商: gōng shāng
姜义森: jiāng yì sēn
海岛: hǎi dǎo
海峡: hǎi xiá
充裕: chōng yù
礁鲨: jiāo shā
全新: quán xīn
商旅: shāng lǚ
陈板: chén bǎn
特征: tè zhēng
全文: quán wén
谐音: xié yīn
特快: tè kuài
西峡: xī xiá
实用性: shí yòng xìng
修法: xiū fǎ
帐户: zhàng hù
故宫: gù gōng
玉器: yù qì
回响热烈: huí xiǎng rè liè
奖状: jiǎng zhuàng
走向: zǒu xiàng
海口: hǎi kǒu
林业界: lín yè jiè
49.4: 4 9 . 4
问到: wèn dào
时候: shí hòu
设在: shè zài
认养: rèn yǎng
刘炳圭: liú bǐng guī
薛岳: xuē yuè
布满: bù mǎn
录音界: lù yīn jiè
陈桥: chén qiáo
奖牌: jiǎng pái
课题: kè tí
流出: liú chū
海协: hǎi xié
赤诚: chì chéng
撤出: chè chū
庆贺: qìng hè
商武: shāng wǔ
酵素: jiào sù
日用品: rì yòng pǐn
庆赏: qìng shǎng
撤军: chè jūn
问及: wèn jí
买回: mǎi huí
直陈: zhí chén
23.4: 2 3 . 4
领导: lǐng dǎo
输入法: shū rù fǎ
特制: tè zhì
特刊: tè kān
海军: hǎi jūn
川东: chuān dōng
问候: wèn hòu
商标: shāng biāo
镜面: jìng miàn
啤酒: pí jiǔ
商检: shāng jiǎn
药丸: yào wán
全面性: quán miàn xìng
曹启鸿: cáo qǐ hóng
海关: hǎi guān
撤到: chè dào
时势: shí shì
unknown: u n k n o w n
www.y2kmfg.gov.tw: w w w . y 2 k m f g . g o v . t w
佳冬: jiā dōng
吉安: jí ān
１１．６: １ １ ． ６
先手: xiān shǒu
换防: huàn fáng
索赔: suǒ péi
峨眉: é méi
坟墓: fén mù
点点: diǎn diǎn
72.02: 7 2 . 0 2
商榷: shāng què
72.08: 7 2 . 0 8
陈欠: chén qiàn
燃起: rán qǐ
买卖: mǎi mài
急躁: jí zào
功效: gōng xiào
丰泰: fēng tài
代表们: dài biǎo men
泰国: tài guó
东面: dōng miàn
领带: lǐng dài
工程院: gōng chéng yuàn
艺人: yì rén
灵魂: líng hún
危危: wēi wēi
烧窑: shāo yáo
海域: hǎi yù
４１亿: ４ １ yì
陈江: chén jiāng
安抚: ān fǔ
国务院: guó wù yuàn
琼海: qióng hǎi
旧社: jiù shè
萨米·索萨: sà mǐ · suǒ sà
危及: wēi jí
工序: gōng xù
饭岛爱: fàn dǎo ài
标记: biāo jì
购汇: gòu huì
诞生: dàn shēng
必备: bì bèi
枢纽: shū niǔ
锺琴: zhōng qín
永安: yǒng ān
偶像: ǒu xiàng
走入: zǒu rù
授权书: shòu quán shū
军用: jūn yòng
索讨: suǒ tǎo
徒步: tú bù
Fellows: F e l l o w s
买到: mǎi dào
永富: yǒng fù
代收费: dài shōu fèi
决策者: jué cè zhě
taconet: t a c o n e t
袁雪芬: yuán xuě fēn
走出: zǒu chū
影评: yǐng píng
专心: zhuān xīn
负责: fù zé
周业丰: zhōu yè fēng
负起: fù qǐ
赤贫: chì pín
布桩: bù zhuāng
全民: quán mín
总书记: zǒng shū jì
男人志: nán rén zhì
扩改建: kuò gǎi jiàn
球星: qiú xīng
走到: zǒu dào
负伤: fù shāng
晋升: jìn shēng
渔获: yú huò
村民: cūn mín
执法: zhí fǎ
三两三: sān liǎng sān
崔梅芬: cuī méi fēn
Liyutan: L i y u t a n
167: 1 6 7
走势: zǒu shì
走动: zǒu dòng
渔船: yú chuán
博物院: bó wù yuàn
渔舟: yú zhōu
私营: sī yíng
请来: qǐng lái
债权: zhài quán
必定: bì dìng
incredible: i n c r e d i b l e
邱翔钟: qiū xiáng zhōng
稀释: xī shì
污水: wū shuǐ
１４．５亿: １ ４ ． ５ yì
直选: zhí xuǎn
歌唱界: gē chàng jiè
微型: wēi xíng
漳州: zhāng zhōu
励志: lì zhì
逆境: nì jìng
鲔钓: wěi diào
文字学: wén zì xué
东欧: dōng ōu
凄惨: qī cǎn
Samsung: S a m s u n g
制成品: zhì chéng pǐn
……: … …
攸关: yōu guān
史记: shǐ jì
漫漫: màn màn
产品: chǎn pǐn
改弦易辙: gǎi xián yì zhé
庆生: qìng shēng
亚历克: yà lì kè
互补: hù bǔ
袭来: xí lái
三十三点二四亿: sān shí sān diǎn èr sì yì
郑耀棠: zhèng yào táng
四十三亿: sì shí sān yì
轻纺: qīng fǎng
谋求: móu qiú
准时: zhǔn shí
７亿: ７ yì
颗D: kē D
灵敏: líng mǐn
货轮: huò lún
出口额: chū kǒu é
互访: hù fǎng
连线: lián xiàn
托管: tuō guǎn
囹圄: líng yǔ
产国: chǎn guó
湄州湾: méi zhōu wān
锺秀梅: zhōng xiù méi
商邱: shāng qiū
松树: sōng shù
连绵: lián mián
连续: lián xù
导师: dǎo shī
怒骂: nù mà
镜湖: jìng hú
世界报: shì jiè bào
舞厅: wǔ tīng
鸡婆: jī pó
连署: lián shǔ
纯然: chún rán
基因: jī yīn
航线: háng xiàn
银壶: yín hú
群起: qún qǐ
专业性: zhuān yè xìng
闹剧: nào jù
法兰西: fǎ lán xī
导引: dǎo yǐn
普杰镇: pǔ jié zhèn
伦理: lún lǐ
产值: chǎn zhí
陈铭: chén míng
驶进: shǐ jìn
4.07: 4 . 0 7
购销: gòu xiāo
卖出: mài chū
确认: què rèn
基准: jī zhǔn
史迹: shǐ jī
力保: lì bǎo
全集: quán jí
珠算: zhū suàn
张健: zhāng jiàn
笔记型: bǐ jì xíng
１５０: １ ５ ０
弘扬: hóng yáng
１５６: １ ５ ６
１５％: １ ５ ％
军购: jūn gòu
卫视: wèi shì
全面: quán miàn
绵延: mián yán
力争: lì zhēng
京沪: jīng hù
警备: jǐng bèi
佳欣: jiā xīn
产出: chǎn chū
唐代: táng dài
办报: bàn bào
管理法: guǎn lǐ fǎ
对策: duì cè
东海: dōng hǎi
迈步: mài bù
唱舞: chàng wǔ
侨务: qiáo wù
侨办: qiáo bàn
燃烧: rán shāo
２０７６: ２ ０ ７ ６
for: f o r
松江: sōng jiāng
店亭: diàn tíng
饲养: sì yǎng
银川: yín chuān
ＰＯＳ: Ｐ Ｏ Ｓ
极力: jí lì
Touchien: T o u c h i e n
闲情偶寄: xián qíng ǒu jì
银山: yín shān
引领人: yǐn lǐng rén
东汉: dōng hàn
总设计师: zǒng shè jì shī
艺文界: yì wén jiè
call: c a l l
带鱼: dài yú
张利: zhāng lì
２００: ２ ０ ０
庭审: tíng shěn
兵书: bīng shū
晴天: qíng tiān
诞辰: dàn chén
争端: zhēng duān
赔偿法: péi cháng fǎ
奖赏: jiǎng shǎng
肯定: kěn dìng
燃煤: rán méi
村镇: cūn zhèn
张力: zhāng lì
素来: sù lái
在即: zài jí
连理: lián lǐ
换文: huàn wén
腾飞: téng fēi
权责: quán zé
财产: cái chǎn
新竹县: xīn zhú xiàn
鸡公: jī gōng
谢霆峰: xiè tíng fēng
Research: R e s e a r c h
竹围: zhú wéi
2.69: 2 . 6 9
置产: zhì chǎn
松冈满寿男: sōng gāng mǎn shòu nán
四千亿: sì qiān yì
ＴＮＴ: Ｔ Ｎ Ｔ
松手: sōng shǒu
微弱: wēi ruò
途径: tú jìng
鲔鱼: wěi yú
旧货: jiù huò
置业: zhì yè
导向: dǎo xiàng
维尔京群岛: wéi ěr jīng qún dǎo
候选: hòu xuǎn
钜变: jù biàn
谋杀: móu shā
深交所: shēn jiāo suǒ
三十三亿: sān shí sān yì
实习: shí xí
实业: shí yè
１３日: １ ３ rì
卸货: xiè huò
回函: huí hán
互联: hù lián
党营: dǎng yíng
消弭: xiāo mǐ
捕鱼: bǔ yú
班轮: bān lún
宋代: sòng dài
图们江: tú men jiāng
争睹: zhēng dǔ
保险业: bǎo xiǎn yè
逆势: nì shì
抚慰: fǔ wèi
皮棉: pí mián
张张: zhāng zhāng
张开: zhāng kāi
基纳纳: jī nà nà
轻盈: qīng yíng
２１０亿: ２ １ ０ yì
全额: quán é
宝贵: bǎo guì
充电: chōng diàn
慈天宫: cí tiān gōng
换来: huàn lái
赵新考: zhào xīn kǎo
直销商: zhí xiāo shāng
协理: xié lǐ
２２０１．７８亿: ２ ２ ０ １ ． ７ ８ yì
纷歧: fēn qí
举世: jǔ shì
松懈: sōng xiè
下士: xià shì
管理所: guǎn lǐ suǒ
算命: suàn mìng
微小: wēi xiǎo
驾驶: jià shǐ
驾驭: jià yù
基建: jī jiàn
负笈: fù jí
丰田: fēng tián
总督府: zǒng dū fǔ
范围: fàn wéi
索索: suǒ suǒ
沧桑史: cāng sāng shǐ
张庚: zhāng gēng
战鼓: zhàn gǔ
摊开: tān kāi
军营: jūn yíng
陈畅鸣: chén chàng míng
在在: zài zài
民生报: mín shēng bào
耍宝: shuǎ bǎo
专人: zhuān rén
劳动力: láo dòng lì
博学多闻: bó xué duō wén
先生: xiān shēng
执黑: zhí hēi
先锋: xiān fēng
微孔: wēi kǒng
花莲县: huā lián xiàn
标箱: biāo xiāng
总资产: zǒng zī chǎn
成绩: chéng jī
直拨: zhí bō
外汇局: wài huì jú
视力: shì lì
外乎: wài hū
萧萧: xiāo xiāo
再三: zài sān
产妇: chǎn fù
郑成功: zhèng chéng gōng
慰问: wèi wèn
纯美: chún měi
人权版: rén quán bǎn
欢欣鼓舞: huān xīn gǔ wǔ
桌球: zhuō qiú
杳然: yǎo rán
警务: jǐng wù
库务: kù wù
私生: sī shēng
换股: huàn gǔ
文武: wén wǔ
驻军法: zhù jūn fǎ
伊滕忠: yī téng zhōng
球队: qiú duì
胸花: xiōng huā
用笔: yòng bǐ
管理权: guǎn lǐ quán
下乡: xià xiāng
LKK: L K K
书展: shū zhǎn
NOKIA: N O K I A
静下: jìng xià
张宸: zhāng chén
刘厚生: liú hòu shēng
韩文: hán wén
２６日: ２ ６ rì
５．８２亿: ５ ． ８ ２ yì
Manukau: M a n u k a u
劳动党: láo dòng dǎng
仲裁法: zhòng cái fǎ
DRAM: D R A M
出席者: chū xí zhě
工商业: gōng shāng yè
浙赣: zhè gàn
罗卓瑶: luó zhuō yáo
新闻局: xīn wén jú
舞弊: wǔ bì
警卫: jǐng wèi
换手: huàn shǒu
佳慧: jiā huì
李礼辉: lǐ lǐ huī
加快: jiā kuài
攀缘: pān yuán
义工群: yì gōng qún
侠盗: xiá dào
评鉴: píng jiàn
骗汇: piàn huì
加征: jiā zhēng
实在: shí zài
佳绩: jiā jī
力学: lì xué
牛津: niú jīn
题字: tí zì
恐龙蛋: kǒng lóng dàn
竹东: zhú dōng
球袋: qiú dài
在乎: zài hū
陈耕: chén gēng
加开: jiā kāi
琉璃珠: liú lí zhū
歧视性: qí shì xìng
赛德克人: sài dé kè rén
规避: guī bì
渔民: yú mín
徐奉洙: xú fèng zhū
６００亿: ６ ０ ０ yì
直线: zhí xiàn
军饷: jūn xiǎng
渔汛: yú xùn
充满: chōng mǎn
希望: xī wàng
再则: zài zé
beautiful: b e a u t i f u l
东端: dōng duān
花莲人: huā lián rén
傩剧: nuó jù
进出口额: jìn chū kǒu é
加工: jiā gōng
丰沛: fēng pèi
用来: yòng lái
加州: jiā zhōu
评选: píng xuǎn
IPO: I P O
兵器: bīng qì
全职: quán zhí
军马: jūn mǎ
纯情: chún qíng
NGO: N G O
李生江: lǐ shēng jiāng
３３４: ３ ３ ４
汰旧换新: tài jiù huàn xīn
９·８５０: ９ · ８ ５ ０
奖项: jiǎng xiàng
圆滚滚: yuán gǔn gǔn
充沛: chōng pèi
三班制: sān bān zhì
绩效: jī xiào
对手国: duì shǒu guó
抽象: chōu xiàng
廊街: láng jiē
Ｂ股: Ｂ gǔ
066: 0 6 6
渔源: yú yuán
等第: děng dì
等等: děng děng
tpc: t p c
摇钱: yáo qián
品酒: pǐn jiǔ
小学生: xiǎo xué shēng
９４０: ９ ４ ０
加密: jiā mì
松绑: sōng bǎng
财务: cái wù
置办: zhì bàn
练出: liàn chū
财力: cái lì
连续性: lián xù xìng
举出: jǔ chū
举凡: jǔ fán
先贤: xiān xián
举债: jǔ zhài
５３·５: ５ ３ · ５
球赛: qiú sài
佳肴: jiā yáo
回忆: huí yì
实则: shí zé
工程署: gōng chéng shǔ
糯米: nuò mǐ
殿堂: diàn táng
吕克俭: lǚ kè jiǎn
鲁泰: lǔ tài
实力: shí lì
慵懒: yōng lǎn
纯林: chún lín
丰歉: fēng qiàn
东线: dōng xiàn
实务: shí wù
先进: xiān jìn
捕获: bǔ huò
加连威: jiā lián wēi
等级: děng jí
蔗糖: zhè táng
归类: guī lèi
邀请赛: yāo qǐng sài
兵力: bīng lì
十二点三亿: shí èr diǎn sān yì
索性: suǒ xìng
历史剧: lì shǐ jù
细则: xì zé
黑手: hēi shǒu
污蔑: wū miè
续签: xù qiān
快递: kuài dì
1966: 1 9 6 6
围困: wéi kùn
唐山: táng shān
用户: yòng hù
全球性: quán qiú xìng
杨文卿: yáng wén qīng
历历: lì lì
管弦: guǎn xián
举动: jǔ dòng
耽误: dān wù
剧响: jù xiǎng
德钦: dé qīn
兵变: bīng biàn
保险史: bǎo xiǎn shǐ
舟山: zhōu shān
乔娅: qiáo yà
CPU: C P U
赵海娟: zhào hǎi juān
维修: wéi xiū
Talking: T a l k i n g
文汇报: wén huì bào
安佳尔: ān jiā ěr
竹东镇: zhú dōng zhèn
遵循: zūn xún
向阳: xiàng yáng
丰晖: fēng huī
征收: zhēng shōu
商誉: shāng yù
键盘: jiàn pán
F-16: F - 1 6
田赋: tián fù
加固: jiā gù
直直: zhí zhí
乡公所: xiāng gōng suǒ
厉威廉: lì wēi lián
佩德鲁索: pèi dé lǔ suǒ
用水: yòng shuǐ
练成: liàn chéng
力劝: lì quàn
high: h i g h
粤西: yuè xī
马吉德: mǎ jí dé
艳阳: yàn yáng
赞赏: zàn shǎng
竞争力: jìng zhēng lì
商讨: shāng tǎo
连日: lián rì
商议: shāng yì
商讯: shāng xùn
药局: yào jú
托持: tuō chí
愿因: yuàn yīn
产业: chǎn yè
球艺: qiú yì
产下: chǎn xià
邀访: yāo fǎng
刘史忠: liú shǐ zhōng
破碎: pò suì
渔村: yú cūn
课程: kè chéng
邀请: yāo qǐng
置屋: zhì wū
小时候: xiǎo shí hòu
管制: guǎn zhì
FUN: F U N
侨乡: qiáo xiāng
卫队: wèi duì
轻易: qīng yì
富士山: fù shì shān
管理班: guǎn lǐ bān
废物: fèi wù
所谓: suǒ wèi
蹉商: cuō shāng
煽惑: shān huò
京珠: jīng zhū
煽情: shān qíng
漫画: màn huà
静寂: jìng jì
陈诉: chén sù
东瀛: dōng yíng
静宜: jìng yí
汉诺威: hàn nuò wēi
兵役法: bīng yì fǎ
轻柔: qīng róu
义贼: yì zéi
村规: cūn guī
细微: xì wēi
随堂: suí táng
举座: jǔ zuò
Ｉａｎ: Ｉ ａ ｎ
丰收: fēng shōu
孝顺: xiào shùn
３亿: ３ yì
轻松: qīng sōng
贡寮: gòng liáo
张云: zhāng yún
糖蜜: táng mì
托收: tuō shōu
私权: sī quán
River: R i v e r
氛围: fēn wéi
京畿: jīng jī
轻轻松松: qīng qīng sōng sōng
实密: shí mì
森工: sēn gōng
农工业: nóng gōng yè
标段: biāo duàn
恐怖: kǒng bù
cm: c m
cd: c d
财富: cái fù
２１３５亿: ２ １ ３ ５ yì
进士: jìn shì
加剧: jiā jù
玩笑: wán xiào
虔诚: qián chéng
加利: jiā lì
腾贵: téng guì
举士: jǔ shì
点到: diǎn dào
必备品: bì bèi pǐn
特洛伊·肯普: tè luò yī · kěn pǔ
力图: lì tú
工商局: gōng shāng jú
连战: lián zhàn
连成: lián chéng
军队: jūn duì
点出: diǎn chū
聚纺: jù fǎng
商谈: shāng tán
Priceline.com: P r i c e l i n e . c o m
加入: jiā rù
小媳妇: xiǎo xí fù
加元: jiā yuán
五千多: wǔ qiān duō
绝迹: jué jī
布袋: bù dài
纷纷: fēn fēn
曹薰铉: cáo xūn xuàn
罗马人: luó mǎ rén
书香门第: shū xiāng mén dì
细密: xì mì
赤水: chì shuǐ
项目库: xiàng mù kù
沃尔芬森: wò ěr fēn sēn
陈述: chén shù
愧疚: kuì jiù
四千多: sì qiān duō
丰富性: fēng fù xìng
争执: zhēng zhí
商贸: shāng mào
商贩: shāng fàn
全资: quán zī
岛国: dǎo guó
加做: jiā zuò
准确: zhǔn què
凄美: qī měi
加值: jiā zhí
赛德克群: sài dé kè qún
工艺: gōng yì
旺季: wàng jì
１８日: １ ８ rì
买进: mǎi jìn
新近: xīn jìn
胡锦涛: hú jǐn tāo
负债: fù zhài
香水: xiāng shuǐ
海宇: hǎi yǔ
静态: jìng tài
香江: xiāng jiāng
渔工: yú gōng
0.36: 0 . 3 6
点滴: diǎn dī
乏人问津: fá rén wèn jīn
走走: zǒu zǒu
苍老: cāng lǎo
产生: chǎn shēng
睦镇硕: mù zhèn shuò
轻工: qīng gōng
１１．１９: １ １ ． １ ９
视线: shì xiàn
侨界: qiáo jiè
用品: yòng pǐn
享誉: xiǎng yù
专制: zhuān zhì
龙山: lóng shān
诗词: shī cí
侨生: qiáo shēng
徐晓钟: xú xiǎo zhōng
张璞: zhāng pú
下院: xià yuàn
实效: shí xiào
加深: jiā shēn
下陷: xià xiàn
１３亿: １ ３ yì
买走: mǎi zǒu
认证: rèn zhèng
连带: lián dài
举杯: jǔ bēi
出入境: chū rù jìng
买贵: mǎi guì
举杖: jǔ zhàng
辅导级: fǔ dǎo jí
碑记: bēi jì
割下: gē xià
下面: xià miàn
细柔: xì róu
轻微: qīng wēi
薪资: xīn zī
换代: huàn dài
轻忽: qīng hū
梁文耀: liáng wén yào
刘向东: liú xiàng dōng
轻快: qīng kuài
特展室: tè zhǎn shì
兵权: bīng quán
陈欣评: chén xīn píng
走近: zǒu jìn
刘镇武: liú zhèn wǔ
走进: zǒu jìn
工商户: gōng shāng hù
妥贴: tuǒ tiē
时评: shí píng
孙翠凤: sūn cuì fèng
换下: huàn xià
加氢: jiā qīng
连忙: lián máng
警署: jǐng shǔ
侨眷: qiáo juàn
苍苍: cāng cāng
申请者: shēn qǐng zhě
抛弃: pāo qì
迅速: xùn sù
充实: chōng shí
设计: shè jì
牛奶: niú nǎi
持证人: chí zhèng rén
争夺: zhēng duó
快步: kuài bù
在编: zài biān
历史性: lì shǐ xìng
算算: suàn suàn
普吉岛: pǔ jí dǎo
张徐顺: zhāng xú shùn
私德: sī dé
认购: rèn gòu
残败: cán bài
蝉联: chán lián
代表队: dài biǎo duì
工蚁: gōng yǐ
陈博志: chén bó zhì
松下: sōng xià
com: c o m
特质: tè zhì
四十五亿: sì shí wǔ yì
柔软: róu ruǎn
香榭: xiāng xiè
竹简: zhú jiǎn
实战: shí zhàn
嘉惠: jiā huì
丰富: fēng fù
撤走: chè zǒu
驳船: bó chuán
盐寮: yán liáo
暂时: zàn shí
东亚: dōng yà
Mini: M i n i
东京: dōng jīng
推荐: tuī jiàn
残迹: cán jī
倾销: qīng xiāo
享负: xiǎng fù
专营: zhuān yíng
苍蝇: cāng yíng
惩戒: chéng jiè
妇人: fù rén
纯品: chún pǐn
标准: biāo zhǔn
现下: xiàn xià
标出: biāo chū
连续剧: lián xù jù
新闻界: xīn wén jiè
森林: sēn lín
消灾: xiāo zāi
消灭: xiāo miè
布条: bù tiáo
电话费: diàn huà fèi
问起: wèn qǐ
用到: yòng dào
力求: lì qiú
旅帛: lǚ bó
管理人: guǎn lǐ rén
举报: jǔ bào
实惠: shí huì
SHOW: S H O W
颓然: tuí rán
用功: yòng gōng
走访: zǒu fǎng
诺亚: nuò yà
Garage.com: G a r a g e . c o m
妥善: tuǒ shàn
特考: tè kǎo
冬阳: dōng yáng
挂碍: guà ài
范畴: fàn chóu
江阴: jiāng yīn
财源: cái yuán
赤字: chì zì
海菜: hǎi cài
快板: kuài bǎn
特联: tè lián
标志: biāo zhì
陷到: xiàn dào
流逝: liú shì
煽动: shān dòng
遮断器: zhē duàn qì
加权: jiā quán
鲁凯: lǔ kǎi
爵士: jué shì
河川局: hé chuān jú
盈利面: yíng lì miàn
视盘: shì pán
Ｙ２Ｋ: Ｙ ２ Ｋ
灵丹: líng dān
维维: wéi wéi
银牌: yín pái
五代十国: wǔ dài shí guó
产业升级: chǎn yè shēng jí
认股: rèn gǔ
持股: chí gǔ
７日: ７ rì
2754-1255: 2 7 5 4 - 1 2 5 5
MMA: M M A
炒手: chǎo shǒu
程序: chéng xù
４０多: ４ ０ duō
撼动: hàn dòng
新闻稿: xīn wén gǎo
专访: zhuān fǎng
专训: zhuān xùn
算盘: suàn pán
工友: gōng yǒu
索引: suǒ yǐn
警界: jǐng jiè
孙玉玺: sūn yù xǐ
１４０００: １ ４ ０ ０ ０
１４００１: １ ４ ０ ０ １
张网: zhāng wǎng
张罗: zhāng luó
使馆: shǐ guǎn
领衔: lǐng xián
１１５．５３: １ １ ５ ． ５ ３
渡轮: dù lún
川黔: chuān qián
德新社: dé xīn shè
领袖: lǐng xiù
引来: yǐn lái
性质: xìng zhì
避风点: bì fēng diǎn
十亿多: shí yì duō
用心: yòng xīn
新闻社: xīn wén shè
乔木: qiáo mù
实习生: shí xí shēng
轻型: qīng xíng
庆功宴: qìng gōng yàn
竞争性: jìng zhēng xìng
警矛: jǐng máo
贸易额: mào yì é
外资股: wài zī gǔ
集装箱: jí zhuāng xiāng
陷入: xiàn rù
执掌: zhí zhǎng
愿望: yuàn wàng
赤壁: chì bì
冬闲: dōng xián
微米: wēi mǐ
争先: zhēng xiān
壮阔: zhuàng kuò
PE: P E
申请表: shēn qǐng biǎo
威尔利: wēi ěr lì
门诊: mén zhěn
进帐: jìn zhàng
微笑: wēi xiào
题材: tí cái
新闻网: xīn wén wǎng
张禹: zhāng yǔ
热卖: rè mài
丰厚: fēng hòu
崔梅兰: cuī méi lán
基础: jī chǔ
新力: xīn lì
营业日: yíng yè rì
第１８: dì １ ８
管哲晖: guǎn zhé huī
乖舛: guāi chuǎn
艰困: jiān kùn
静浦: jìng pǔ
易懂: yì dǒng
灰姑娘: huī gū niáng
渔轮: yú lún
专辑: zhuān jí
岛链: dǎo liàn
购买欲: gòu mǎi yù
纷乱: fēn luàn
警犬: jǐng quǎn
消费性: xiāo fèi xìng
海藻: hǎi zǎo
徽宗: huī zōng
歌颂: gē sòng
Show: S h o w
极端: jí duān
走私案: zǒu sī àn
杯酒: bēi jiǔ
妥协: tuǒ xié
纷争: fēn zhēng
必纯士: bì chún shì
健保费: jiàn bǎo fèi
斩首: zhǎn shǒu
邬志星: wū zhì xīng
工资: gōng zī
国民党: guó mín dǎng
唱盘: chàng pán
６１．５３: ６ １ ． ５ ３
工贸: gōng mào
专责: zhuān zé
hiro: h i r o
视点: shì diǎn
争利: zhēng lì
残虐: cán nüè
海葵: hǎi kuí
保健品: bǎo jiàn pǐn
加总: jiā zǒng
66.76: 6 6 . 7 6
楚崧秋: chǔ sōng qiū
韩国队: hán guó duì
CAMRY: C A M R Y
６．３２: ６ ． ３ ２
丰产: fēng chǎn
下营: xià yíng
直径: zhí jìng
铁轨: tiě guǐ
PowerDVD: P o w e r D V D
张先国: zhāng xiān guó
浓浊: nóng zhuó
东宝: dōng bǎo
再现: zài xiàn
门面: mén miàn
蒋秋生: jiǎng qiū shēng
７０多: ７ ０ duō
点缀: diǎn zhuì
锤炼: chuí liàn
消极: xiāo jí
鹭鸶: lù sī
漫延: màn yán
加纳: jiā nà
终审权: zhōng shěn quán
保险界: bǎo xiǎn jiè
练球: liàn qiú
凄凄: qī qī
第６: dì ６
第４: dì ４
第２: dì ２
第３: dì ３
第１: dì １
导流: dǎo liú
窜起: cuàn qǐ
苍郁: cāng yù
微晶: wēi jīng
钜棚: jù péng
妩媚: wǔ mèi
仁爱: rén ài
黄辉珍: huáng huī zhēn
实用: shí yòng
李德汉: lǐ dé hàn
李德民: lǐ dé mín
问题: wèn tí
老人: lǎo rén
杨小云: yáng xiǎo yún
铸成: zhù chéng
管管: guǎn guǎn
篮球队: lán qiú duì
照顾: zhào gù
姊姊: zǐ zǐ
预谋: yù móu
渔业: yú yè
线索: xiàn suǒ
姊妹: zǐ mèi
现象: xiàn xiàng
产权: chǎn quán
１１．９０: １ １ ． ９ ０
续建: xù jiàn
Paganica: P a g a n i c a
外资额: wài zī é
轻伤: qīng shāng
渔产: yú chǎn
产林: chǎn lín
森林浴: sēn lín yù
举目: jǔ mù
讨债鬼: tǎo zhài guǐ
The: T h e
闲闲: xián xián
惜物: xī wù
犯错: fàn cuò
领队: lǐng duì
渤海: bó hǎi
７．２２亿: ７ ． ２ ２ yì
工程师: gōng chéng shī
洛阳纸贵: luò yáng zhǐ guì
田埂: tián gěng
天使岛: tiān shǐ dǎo
献花: xiàn huā
1.81: 1 . 8 1
启动: qǐ dòng
警检: jǐng jiǎn
财物: cái wù
鄂东: è dōng
豪富: háo fù
苏州: sū zhōu
Park: P a r k
维持: wéi chí
东德: dōng dé
实现: shí xiàn
工商界: gōng shāng jiè
歌舞: gē wǔ
私下: sī xià
实物: shí wù
管理局: guǎn lǐ jú
管理层: guǎn lǐ céng
京山: jīng shān
维护: wéi hù
唐纳: táng nà
海鸥: hǎi ōu
详讯: xiáng xùn
冬训: dōng xùn
私人: sī rén
Wushantou: W u s h a n t o u
准则: zhǔn zé
逆流: nì liú
农产品: nóng chǎn pǐn
松弛: sōng chí
李凤双: lǐ fèng shuāng
流走: liú zǒu
静电: jìng diàn
迟迟: chí chí
轮胎: lún tāi
761: 7 6 1
管线: guǎn xiàn
劳力密集型: láo lì mì jí xíng
椭圆形: tuǒ yuán xíng
复制品: fù zhì pǐn
遵照: zūn zhào
马樱丹: mǎ yīng dān
ＩＢＭ: Ｉ Ｂ Ｍ
准入: zhǔn rù
东势街: dōng shì jiē
歌者: gē zhě
76: 7 6
伊敏: yī mǐn
消息: xiāo xī
刘彤: liú tóng
设计师: shè jì shī
江西: jiāng xī
产销班: chǎn xiāo bān
79: 7 9
袭击: xí jī
张连业: zhāng lián yè
林宣根: lín xuān gēn
鱼鳞甲: yú lín jiǎ
屋顶: wū dǐng
流进: liú jìn
流连: liú lián
妇德: fù dé
海鳗: hǎi mán
专门: zhuān mén
安检: ān jiǎn
玩具: wán jù
到资: dào zī
加码: jiā mǎ
东岸: dōng àn
飘带型: piāo dài xíng
go: g o
细粒: xì lì
松动: sōng dòng
连线版: lián xiàn bǎn
设备用: shè bèi yòng
算来: suàn lái
课堂: kè táng
时速: shí sù
等候: děng hòu
迄今: qì jīn
偷渡者: tōu dù zhě
选风: xuǎn fēng
玉雕: yù diāo
残酷: cán kù
舢板: shān bǎn
初来: chū lái
拦砂坝: lán shā bà
侨民: qiáo mín
撤退: chè tuì
１０８．９亿: １ ０ ８ ． ９ yì
下起: xià qǐ
灵师: líng shī
马桶: mǎ tǒng
竹林: zhú lín
晴朗: qíng lǎng
迈向: mài xiàng
９·９００: ９ · ９ ０ ０
釜山: fǔ shān
课外: kè wài
危险: wēi xiǎn
设防: shè fáng
香甜: xiāng tián
走私罪: zǒu sī zuì
NHK: N H K
音响室: yīn xiǎng shì
瑜珈: yú jiā
东势: dōng shì
东加: dōng jiā
专项: zhuān xiàng
李铁拐: lǐ tiě guǎi
细细: xì xì
门口: mén kǒu
河西: hé xī
薛鸿: xuē hóng
抚养: fǔ yǎng
韩元: hán yuán
请求: qǐng qiú
史博馆: shǐ bó guǎn
等到: děng dào
防霉: fáng méi
帅帅: shuài shuài
倾覆: qīng fù
歌谣: gē yáo
二奶: èr nǎi
镀锡: dù xī
回乡证: huí xiāng zhèng
灵巧: líng qiǎo
山羊绒: shān yáng róng
照遍: zhào biàn
荟萃: huì cuì
京剧: jīng jù
换回: huàn huí
凄寒: qī hán
入梦: rù mèng
４５００: ４ ５ ０ ０
课室: kè shì
１００００: １ ０ ０ ０ ０
加班: jiā bān
R＆B: R ＆ B
田径: tián jìng
李勇: lǐ yǒng
走遍: zǒu biàn
掣肘: chè zhǒu
下街: xià jiē
迈入: mài rù
攀升: pān shēng
谋利: móu lì
120: 1 2 0
121: 1 2 1
122: 1 2 2
设计商: shè jì shāng
125: 1 2 5
127: 1 2 7
在望: zài wàng
警惕: jǐng tì
必须: bì xū
瓯海: ōu hǎi
迈出: mài chū
管理: guǎn lǐ
皮带: pí dài
海面: hǎi miàn
班彪: bān biāo
战略性: zhàn lüè xìng
归程: guī chéng
时钟: shí zhōng
人文: rén wén
题目: tí mù
歌词: gē cí
豪门: háo mén
韩国: hán guó
海防: hǎi fáng
4.52: 4 . 5 2
工龄: gōng líng
撤销: chè xiāo
弃权: qì quán
素养: sù yǎng
程建人: chéng jiàn rén
点燃: diǎn rán
４０亿: ４ ０ yì
260: 2 6 0
Y2K: Y 2 K
俄裔: é yì
皮尔: pí ěr
警戒: jǐng jiè
巴伐利亚州: bā fá lì yà zhōu
普世性: pǔ shì xìng
京城: jīng chéng
第８７９６: dì ８ ７ ９ ６
准备: zhǔn bèi
佳偶: jiā ǒu
纽西兰人: niǔ xī lán rén
李先仁: lǐ xiān rén
倾谈: qīng tán
海钓: hǎi diào
跃跃: yuè yuè
现职: xiàn zhí
快炒: kuài chǎo
下课: xià kè
问问: wèn wèn
删减: shān jiǎn
巴拿马: bā ná mǎ
秋季: qiū jì
残阳: cán yáng
照常: zhào cháng
饱满: bǎo mǎn
实质性: shí zhì xìng
课後: kè hòu
即日起: jí rì qǐ
速冻藕: sù dòng ǒu
谈到: tán dào
魔法: mó fǎ
密闭: mì bì
谈判: tán pàn
办成: bàn chéng
篮球: lán qiú
徐鸿伟: xú hóng wěi
李志国: lǐ zhì guó
躁进: zào jìn
黄喵喵: huáng miāo miāo
情况: qíng kuàng
贬值: biǎn zhí
口吻: kǒu wěn
来电: lái diàn
瑰宝: guī bǎo
对等: duì děng
寡妇: guǎ fù
学习者: xué xí zhě
挤入: jǐ rù
拿到: ná dào
顾祚维: gù zuò wéi
软盘: ruǎn pán
挤出: jǐ chū
备课: bèi kè
备询: bèi xún
尊严: zūn yán
阐述: chǎn shù
谈及: tán jí
二元: èr yuán
骏河湾: jùn hé wān
死党: sǐ dǎng
直驶: zhí shǐ
笑谈: xiào tán
建物: jiàn wù
黄梅县: huáng méi xiàn
公企: gōng qǐ
Wow: W o w
专用线: zhuān yòng xiàn
猝死: cù sǐ
公保: gōng bǎo
死刑: sǐ xíng
邵宗海: shào zōng hǎi
老老: lǎo lǎo
拿出: ná chū
领域: lǐng yù
西亚: xī yà
退避: tuì bì
木桶: mù tǒng
公义: gōng yì
密集: mì jí
帅哥: shuài gē
遭到: zāo dào
楚雄: chǔ xióng
公业: gōng yè
１．６７６９: １ ． ６ ７ ６ ９
贤臣: xián chén
木棒: mù bàng
情势: qíng shì
亚银: yà yín
板桥: bǎn qiáo
公交: gōng jiāo
二千: èr qiān
二十: èr shí
公亩: gōng mǔ
江国成: jiāng guó chéng
固定: gù dìng
孤伶伶: gū líng líng
利息: lì xī
魔棒: mó bàng
环海: huán hǎi
国际法: guó jì fǎ
开馆: kāi guǎn
凯蒂: kǎi dì
４０００: ４ ０ ０ ０
美联社: měi lián shè
原始: yuán shǐ
匹配: pǐ pèi
7869: 7 8 6 9
改制面: gǎi zhì miàn
三十多亿: sān shí duō yì
网球赛: wǎng qiú sài
初步: chū bù
汴河: biàn hé
紧蹙: jǐn cù
in: i n
然後: rán hòu
权柄: quán bǐng
配偶: pèi ǒu
引用: yǐn yòng
犀牛: xī niú
拿回: ná huí
环河: huán hé
陈威仁: chén wēi rén
时常: shí cháng
楼面: lóu miàn
笑话: xiào huà
训导: xùn dǎo
战乱: zhàn luàn
叙利亚: xù lì yà
Nanhua: N a n h u a
死因: sǐ yīn
天象: tiān xiàng
威力: wēi lì
严德芬: yán dé fēn
www: w w w
原定: yuán dìng
二十三亿: èr shí sān yì
畅销: chàng xiāo
总统府: zǒng tǒng fǔ
战争: zhàn zhēng
战云: zhàn yún
废热: fèi rè
晨鸣: chén míng
——: — —
赞成: zàn chéng
表决: biǎo jué
秀屿: xiù yǔ
壁饰: bì shì
天赋: tiān fù
贫乏: pín fá
蒸煮: zhēng zhǔ
社群: shè qún
婉谢: wǎn xiè
挪用: nuó yòng
兼具: jiān jù
开销: kāi xiāo
联翩: lián piān
邱吉尔: qiū jí ěr
微多孔型: wēi duō kǒng xíng
决战: jué zhàn
1990: 1 9 9 0
急剧: jí jù
口岸: kǒu àn
1995: 1 9 9 5
1997: 1 9 9 7
国际性: guó jì xìng
1998: 1 9 9 8
肃穆: sù mù
21.46: 2 1 . 4 6
废纸: fèi zhǐ
联网: lián wǎng
威尔: wēi ěr
琦琦: qí qí
减低: jiǎn dī
四点四五千亿: sì diǎn sì wǔ qiān yì
开门: kāi mén
建碑: jiàn bēi
富图纳: fù tú nà
减产: jiǎn chǎn
旧书摊: jiù shū tān
11.49: 1 1 . 4 9
船东: chuán dōng
船代: chuán dài
情境: qíng jìng
刚健: gāng jiàn
１３０亿: １ ３ ０ yì
捕捉: bǔ zhuō
隐晦: yǐn huì
秀峦: xiù luán
６０１: ６ ０ １
６００: ６ ０ ０
办案: bàn àn
捏出: niē chū
办桌: bàn zhuō
书艺界: shū yì jiè
棉布: mián bù
总统制: zǒng tǒng zhì
所罗门群岛: suǒ luó mén qún dǎo
欢庆: huān qìng
阁楼: gé lóu
梦想: mèng xiǎng
触犯: chù fàn
戒备: jiè bèi
影后: yǐng hòu
１０００: １ ０ ０ ０
━━: ━ ━
对照: duì zhào
四亿多: sì yì duō
辞职: cí zhí
开阔: kāi kuò
８０００多: ８ ０ ０ ０ duō
护龙河: hù lóng hé
兼制: jiān zhì
今冈益美: jīn gāng yì měi
特困户: tè kùn hù
伤心: shāng xīn
口径: kǒu jìng
按钮: àn niǔ
８日: ８ rì
库存: kù cún
９·８００: ９ · ８ ０ ０
愤愤: fèn fèn
谈妥: tán tuǒ
刚刚: gāng gāng
嘻笑: xī xiào
原因: yuán yīn
木板: mù bǎn
浦东: pǔ dōng
木材: mù cái
座标: zuò biāo
仪表: yí biǎo
原先: yuán xiān
树皮: shù pí
蓄洪: xù hóng
两三: liǎng sān
训养: xùn yǎng
921: 9 2 1
损及: sǔn jí
鸿荣: hóng róng
配备: pèi bèi
废弃物: fèi qì wù
唱出: chàng chū
外销: wài xiāo
笑脸: xiào liǎn
TESCO: T E S C O
蚯蚓: qiū yǐn
板条: bǎn tiáo
箱根: xiāng gēn
猛药: měng yào
外铄: wài shuò
蚊帐: wén zhàng
刘向: liú xiàng
学费: xué fèi
卢仁法: lú rén fǎ
李凯: lǐ kǎi
劣汰: liè tài
木星: mù xīng
Basketball: B a s k e t b a l l
低收入户: dī shōu rù hù
４３６００亿: ４ ３ ６ ０ ０ yì
录影: lù yǐng
引领风骚: yǐn lǐng fēng sāo
案情: àn qíng
然后: rán hòu
１０７亿: １ ０ ７ yì
配对: pèi duì
植物界: zhí wù jiè
情形: qíng xíng
23654036: 2 3 6 5 4 0 3 6
办法: bàn fǎ
外面: wài miàn
关爱: guān ài
叙旧: xù jiù
动物所: dòng wù suǒ
国企: guó qǐ
对生: duì shēng
营建署: yíng jiàn shǔ
纳·淘吉亚: nà · táo jí yà
吸尘器: xī chén qì
赵维: zhào wéi
惯性: guàn xìng
建置: jiàn zhì
原则: yuán zé
新生代: xīn shēng dài
国人: guó rén
隐患: yǐn huàn
国产: guó chǎn
韵律: yùn lǜ
姊妹们: zǐ mèi men
杨国钧: yáng guó jūn
国代: guó dài
小三: xiǎo sān
孵出: fū chū
小丑: xiǎo chǒu
输变电: shū biàn diàn
３４０多: ３ ４ ０ duō
67.19: 6 7 . 1 9
国三: guó sān
补贴: bǔ tiē
Major: M a j o r
郑州: zhèng zhōu
进货: jìn huò
坐下: zuò xià
小五: xiǎo wǔ
职业: zhí yè
来日: lái rì
７５亿: ７ ５ yì
小兵: xiǎo bīng
国军: guó jūn
14: 1 4
拷贝: kǎo bèi
编导: biān dǎo
环礁: huán jiāo
天马: tiān mǎ
开赛: kāi sài
损伤: sǔn shāng
唐三彩: táng sān cǎi
战士: zhàn shì
初级: chū jí
阳刚: yáng gāng
欧美人: ōu měi rén
软杀: ruǎn shā
尤德: yóu dé
小农: xiǎo nóng
砍伐: kǎn fá
公屋: gōng wū
77.81: 7 7 . 8 1
FM.: F M .
普遍: pǔ biàn
国债: guó zhài
昱泉: yù quán
阴影: yīn yǐng
蓄热: xù rè
外表: wài biǎo
农耕: nóng gēng
１２０: １ ２ ０
甜甜: tián tián
贫富: pín fù
贫寒: pín hán
杨山梨: yáng shān lí
保加利亚: bǎo jiā lì yà
冻到: dòng dào
公开: gōng kāi
国史: guó shǐ
沧桑: cāng sāng
建成: jiàn chéng
违法: wéi fǎ
仕绅们: shì shēn men
茑松: niǎo sōng
粗粮: cū liáng
唤回: huàn huí
农药: nóng yào
关渡: guān dù
询问: xún wèn
2287: 2 2 8 7
进退: jìn tuì
凑巧: còu qiǎo
开进: kāi jìn
粗糙: cū cāo
补选: bǔ xuǎn
孤寂: gū jì
誓师: shì shī
摇钱树: yáo qián shù
原丝: yuán sī
慨然: kǎi rán
晚秋: wǎn qiū
国务: guó wù
国力: guó lì
公布: gōng bù
铃响: líng xiǎng
职务: zhí wù
公帐: gōng zhàng
周遭: zhōu zāo
战败国: zhàn bài guó
原乡: yuán xiāng
尊尊: zūn zūn
让贤: ràng xián
局面: jú miàn
忽略: hū lüè
武侠剧: wǔ xiá jù
循环: xún huán
原代: yuán dài
战局: zhàn jú
杰布莱: jié bù lái
剧院: jù yuàn
引擎: yǐn qíng
文德: wén dé
２５日: ２ ５ rì
晶宇: jīng yǔ
铁制: tiě zhì
外资: wài zī
TCL: T C L
权益: quán yì
建管: jiàn guǎn
１３５２０亿: １ ３ ５ ２ ０ yì
外贸: wài mào
牌匾: pái biǎn
阳城: yáng chéng
如愿: rú yuàn
婚姻法: hūn yīn fǎ
初等: chū děng
顾店: gù diàn
减利: jiǎn lì
对渡: duì dù
加工品: jiā gōng pǐn
竞争: jìng zhēng
计费: jì fèi
减到: jiǎn dào
伞类: sǎn lèi
小品: xiǎo pǐn
流变学: liú biàn xué
联手: lián shǒu
船务: chuán wù
公墓: gōng mù
１２０亿: １ ２ ０ yì
渔民们: yú mín men
灭杀: miè shā
目击者: mù jī zhě
值班: zhí bān
宜新: yí xīn
升学: shēng xué
三民街: sān mín jiē
公寓: gōng yù
５００: ５ ０ ０
善用: shàn yòng
开议: kāi yì
外轮: wài lún
开讲: kāi jiǎng
开设: kāi shè
公安: gōng ān
小型: xiǎo xíng
谢汝茂: xiè rǔ mào
国际级: guó jì jí
吉林队: jí lín duì
商业性: shāng yè xìng
国际网: guó jì wǎng
联想: lián xiǎng
战役: zhàn yì
建材: jiàn cái
沧海: cāng hǎi
导盲犬: dǎo máng quǎn
刑律: xíng lǜ
忽然: hū rán
原始林: yuán shǐ lín
输赢: shū yíng
蜂蜜: fēng mì
陈筱梅: chén xiǎo méi
蜜农: mì nóng
０．７５: ０ ． ７ ５
建构: jiàn gòu
笑闹: xiào nào
建桥: jiàn qiáo
隐瞒: yǐn mán
触怒: chù nù
顾及: gù jí
人工林: rén gōng lín
林宜娴: lín yí xián
绢帛: juàn bó
瓷杯: cí bēi
带动: dài dòng
猜到: cāi dào
建树: jiàn shù
引桥: yǐn qiáo
蛊魅: gǔ mèi
贪污: tān wū
减弱: jiǎn ruò
国外: guó wài
进驻: jìn zhù
李志仁: lǐ zhì rén
带到: dài dào
如法: rú fǎ
晶圆: jīng yuán
顶峰: dǐng fēng
五十五亿: wǔ shí wǔ yì
张惠妹: zhāng huì mèi
真诚: zhēn chéng
遮天: zhē tiān
１４２３: １ ４ ２ ３
五二○: wǔ èr ○
榕树: róng shù
爱迪生: ài dí shēng
急诊室: jí zhěn shì
蜘蛛: zhī zhū
起到: qǐ dào
编剧: biān jù
卫生: wèi shēng
林务局: lín wù jú
周杰: zhōu jié
顶尖: dǐng jiān
战况: zhàn kuàng
国宴: guó yàn
小孩: xiǎo hái
小学: xiǎo xué
Haruo: H a r u o
国宝: guó bǎo
废水: fèi shuǐ
国安: guó ān
GMAT: G M A T
隐痛: yǐn tòng
坐实: zuò shí
刘庆禄: liú qìng lù
五十四亿: wǔ shí sì yì
顾全: gù quán
顾秀莲: gù xiù lián
美孚: měi fú
联测: lián cè
煲锅: bāo guō
贺词: hè cí
威严: wēi yán
５２: ５ ２
贪渎: tān dú
志愿: zhì yuàn
锐减: ruì jiǎn
CANON: C A N O N
梁锦松: liáng jǐn sōng
拦截: lán jié
４亿多: ４ yì duō
辞退: cí tuì
粗略: cū lüè
专用权: zhuān yòng quán
佞臣: nìng chén
界定: jiè dìng
来源: lái yuán
梁小略: liáng xiǎo lüè
带入: dài rù
奶奶: nǎi nǎi
减小: jiǎn xiǎo
1.38: 1 . 3 8
木炭: mù tàn
电讯社: diàn xùn shè
关杯: guān bēi
职工: zhí gōng
加工业: jiā gōng yè
带回: dài huí
公关: gōng guān
热腾腾: rè téng téng
湖口: hú kǒu
132: 1 3 2
简瑞璞: jiǎn ruì pú
小工: xiǎo gōng
求职者: qiú zhí zhě
小巴: xiǎo bā
粗犷: cū guǎng
对望: duì wàng
严文斌: yán wén bīn
缘定: yuán dìng
材质: cái zhì
公决: gōng jué
顶多: dǐng duō
菜农: cài nóng
罗纳普朗克: luó nà pǔ lǎng kè
升值: shēng zhí
拿下: ná xià
钱塘江: qián táng jiāng
Center: C e n t e r
起因: qǐ yīn
环球: huán qiú
兰生: lán shēng
锻炼: duàn liàn
小小: xiǎo xiǎo
真迹: zhēn jī
废止: fèi zhǐ
戒严: jiè yán
树杞: shù qǐ
引流: yǐn liú
树木: shù mù
D-RAM: D - R A M
杰瑞: jié ruì
二亿: èr yì
米仓: mǐ cāng
剪裁: jiǎn cái
隐然: yǐn rán
亚视: yà shì
初学者: chū xué zhě
小心: xiǎo xīn
稳定性: wěn dìng xìng
加州鲈: jiā zhōu lú
贺辞: hè cí
战国: zhàn guó
公厅: gōng tīng
决赛权: jué sài quán
李近维: lǐ jìn wéi
1984: 1 9 8 4
国库: guó kù
升到: shēng dào
开航: kāi háng
国府: guó fǔ
1989: 1 9 8 9
贫困: pín kùn
多出: duō chū
如此: rú cǐ
博士: bó shì
李壬癸: lǐ rén guǐ
预警: yù jǐng
89: 8 9
诱惑: yòu huò
畅谈: chàng tán
83: 8 3
亚裔: yà yì
真情: zhēn qíng
开花: kāi huā
情人: qíng rén
忌讳: jì huì
天问: tiān wèn
威尔逊·基普克特: wēi ěr xùn · jī pǔ kè tè
公务: gōng wù
海隅: hǎi yú
闪烁: shǎn shuò
书记: shū jì
初三: chū sān
圆融: yuán róng
二点: èr diǎn
李杰颖: lǐ jié yǐng
磁带: cí dài
公海: gōng hǎi
顶新: dǐng xīn
改编自: gǎi biān zì
安阳: ān yáng
书评: shū píng
配用: pèi yòng
初二: chū èr
违建: wéi jiàn
疯妇: fēng fù
刑案: xíng àn
起步: qǐ bù
滚装: gǔn zhuāng
捡到: jiǎn dào
欣赏: xīn shǎng
室外: shì wài
安静: ān jìng
引出: yǐn chū
怅惘: chàng wǎng
竖琴: shù qín
直销: zhí xiāo
赢利: yíng lì
公民: gōng mín
国情: guó qíng
１１０３．８０亿: １ １ ０ ３ ． ８ ０ yì
普及型: pǔ jí xíng
引入: yǐn rù
阶段性: jiē duàn xìng
end: e n d
宜制: yí zhì
安史: ān shǐ
缘故: yuán gù
编定: biān dìng
黑死病: hēi sǐ bìng
１．８４: １ ． ８ ４
惘然: wǎng rán
职掌: zhí zhǎng
宜兰: yí lán
昼夜: zhòu yè
后者: hòu zhě
对外: duì wài
摇滚: yáo gǔn
汇集: huì jí
麦克杰克森: mài kè jié kè sēn
审计: shěn jì
训练: xùn liàn
审讯: shěn xùn
审议: shěn yì
坐拥: zuò yōng
顶替: dǐng tì
脸庞: liǎn páng
关心: guān xīn
速成: sù chéng
建始县: jiàn shǐ xiàn
陈永贵: chén yǒng guì
BOT案: B O T àn
枪毙: qiāng bì
湖水: hú shuǐ
３０３·００: ３ ０ ３ · ０ ０
企画案: qǐ huà àn
Feitsui: F e i t s u i
执法者: zhí fǎ zhě
竟然: jìng rán
深表: shēn biǎo
ＧＭＰ: Ｇ Ｍ Ｐ
国手: guó shǒu
来函: lái hán
刑法: xíng fǎ
国文: guó wén
骑楼: qí lóu
张学友: zhāng xué yǒu
国旗: guó qí
牵动力: qiān dòng lì
外译: wài yì
小时: xiǎo shí
试验所: shì yàn suǒ
对开: duì kāi
刑求: xíng qiú
黄飞鸿: huáng fēi hóng
建商: jiàn shāng
树心: shù xīn
粉碎: fěn suì
起源: qǐ yuán
志庆: zhì qìng
木业: mù yè
韩多哥: hán duō gē
关外: guān wài
辜负: gū fù
犀利: xī lì
消费额: xiāo fèi é
荣获: róng huò
社工: shè gōng
叩关: kòu guān
ＰＮＴＲ: Ｐ Ｎ Ｔ Ｒ
Ｃ型: Ｃ xíng
十四点四亿: shí sì diǎn sì yì
凛冽: lǐn liè
决策: jué cè
安逸: ān yì
荣耀: róng yào
欣评: xīn píng
多加: duō jiā
建国: jiàn guó
环保: huán bǎo
职权: zhí quán
427: 4 2 7
恒河: héng hé
保额: bǎo é
帮忙: bāng máng
１９３０: １ ９ ３ ０
摘自: zhāi zì
试验性: shì yàn xìng
脸孔: liǎn kǒng
峰巅: fēng diān
猜测: cāi cè
五香: wǔ xiāng
固网: gù wǎng
威玛: wēi mǎ
誓死: shì sǐ
炫耀: xuàn yào
深谈: shēn tán
法律人: fǎ lǜ rén
养生: yǎng shēng
藻类: zǎo lèi
顶托: dǐng tuō
荣膺: róng yīng
JPP: J P P
水利厅: shuǐ lì tīng
来到: lái dào
秩序: zhì xù
水利局: shuǐ lì jú
保险: bǎo xiǎn
对口: duì kǒu
摇摇: yáo yáo
摇摆: yáo bǎi
挤破: jǐ pò
集钱: jí qián
赏赐: shǎng cì
协议: xié yì
晶板: jīng bǎn
贬破: biǎn pò
软弱: ruǎn ruò
升旗: shēng qí
绚烂: xuàn làn
公斤: gōng jīn
汉宝德: hàn bǎo dé
琦君: qí jūn
蓄水库: xù shuǐ kù
挪威: nuó wēi
帮凶: bāng xiōng
梆笛: bāng dí
木竹: mù zhú
原理: yuán lǐ
废弃: fèi qì
录音社: lù yīn shè
窘境: jiǒng jìng
郑安国: zhèng ān guó
固然: gù rán
１４: １ ４
念出: niàn chū
建备: jiàn bèi
孤悬: gū xuán
近邻: jìn lín
损益: sǔn yì
建始: jiàn shǐ
书艺: shū yì
编成: biān chéng
龙开河: lóng kāi hé
联席: lián xí
荣辱: róng rǔ
画展: huà zhǎn
酒醉: jiǔ zuì
挂起: guà qǐ
近郊: jìn jiāo
文学性: wén xué xìng
集集: jí jí
弓形: gōng xíng
对决: duì jué
GPS: G P S
座下: zuò xià
摘走: zhāi zǒu
后裔: hòu yì
触动: chù dòng
刘峻岫: liú jùn xiù
棉纱: mián shā
辞汇: cí huì
橡木: xiàng mù
笔直: bǐ zhí
配置: pèi zhì
尊敬: zūn jìng
国歌: guó gē
顾钱江: gù qián jiāng
引导: yǐn dǎo
冻死: dòng sǐ
贪快: tān kuài
错愕: cuò è
贪心: tān xīn
阑珊: lán shān
and: a n d
２４: ２ ４
天晶馆: tiān jīng guǎn
２０: ２ ０
２１: ２ １
２２: ２ ２
１３６０: １ ３ ６ ０
２００多: ２ ０ ０ duō
欧佩克: ōu pèi kè
盎然: àng rán
建安: jiàn ān
筹集: chóu jí
贫户: pín hù
触及: chù jí
What: W h a t
影剧界: yǐng jù jiè
0.41: 0 . 4 1
交易额: jiāo yì é
决定性: jué dìng xìng
对垒: duì lěi
日历: rì lì
联安: lián ān
忠诚: zhōng chéng
口碑: kǒu bēi
楠梓: nán zǐ
乡民们: xiāng mín men
起来: qǐ lái
关停: guān tíng
１０９７．９８亿: １ ０ ９ ７ ． ９ ８ yì
多馀: duō yú
国法: guó fǎ
评级: píng jí
树型: shù xíng
法国人: fǎ guó rén
利润额: lì rùn é
带来: dài lái
国民: guó mín
原点: yuán diǎn
人民镇: rén mín zhèn
二十三日: èr shí sān rì
授勋: shòu xūn
关公: guān gōng
model: m o d e l
关入: guān rù
United: U n i t e d
荣衔: róng xián
来宾: lái bīn
宣宗: xuān zōng
阳江: yáng jiāng
交融: jiāo róng
对唱: duì chàng
贡寮乡: gòng liáo xiāng
卫生纸: wèi shēng zhǐ
of: o f
公所: gōng suǒ
卫生署: wèi shēng shǔ
枪杀: qiāng shā
叛军: pàn jūn
原版: yuán bǎn
小渊: xiǎo yuān
训犬: xùn quǎn
２８日: ２ ８ rì
进攻: jìn gōng
关口: guān kǒu
天后级: tiān hòu jí
旭蟹: xù xiè
回想: huí xiǎng
邱义仁: qiū yì rén
徐文雄: xú wén xióng
妆点: zhuāng diǎn
志向: zhì xiàng
公报: gōng bào
情绪: qíng xù
梁庚尧: liáng gēng yáo
欢笑: huān xiào
帮困: bāng kùn
谈成: tán chéng
权利: quán lì
刘云峰: liú yún fēng
锦标赛: jǐn biāo sài
护旗队: hù qí duì
拿捏: ná niē
权力: quán lì
叛乱: pàn luàn
养成: yǎng chéng
权势: quán shì
2282: 2 2 8 2
隐形: yǐn xíng
奶爸: nǎi bà
梅西亚: méi xī yà
EZ: E Z
原民: yuán mín
急欲: jí yù
李志村: lǐ zhì cūn
Baseball: B a s e b a l l
国卫: guó wèi
奴婢: nú bì
贴近: tiē jìn
ＤＮＡ: Ｄ Ｎ Ａ
拟议: nǐ yì
23084608: 2 3 0 8 4 6 0 8
顾鸣塘: gù míng táng
集资: jí zī
决定: jué dìng
环境: huán jìng
毕宏勇: bì hóng yǒng
电力局: diàn lì jú
初尝: chū cháng
销货: xiāo huò
书香: shū xiāng
巫启贤: wū qǐ xián
险峰: xiǎn fēng
忠门: zhōng mén
谦虚: qiān xū
开始日: kāi shǐ rì
关乎: guān hū
带领人: dài lǐng rén
如醉如痴: rú zuì rú chī
欧阳修: ōu yáng xiū
十馀: shí yú
竞标: jìng biāo
顶益: dǐng yì
办公: bàn gōng
权充: quán chōng
戒备森严: jiè bèi sēn yán
画廊: huà láng
NOVA: N O V A
李宣锋: lǐ xuān fēng
书风: shū fēng
威权: wēi quán
起码: qǐ mǎ
情报: qíng bào
升级: shēng jí
贫穷: pín qióng
小狗: xiǎo gǒu
旱灾: hàn zāi
世贸: shì mào
掌管: zhǎng guǎn
梦幻: mèng huàn
很快: hěn kuài
兰屿: lán yǔ
情收: qíng shōu
868: 8 6 8
汇聚: huì jù
拿来: ná lái
秒钟: miǎo zhōng
新加坡: xīn jiā pō
循吏: xún lì
隐密: yǐn mì
公社: gōng shè
秒针: miǎo zhēn
国画: guó huà
2.8: 2 . 8
林希翎: lín xī líng
推来: tuī lái
刘晖: liú huī
护面墙: hù miàn qiáng
６０: ６ ０
６１: ６ １
６２: ６ ２
６４: ６ ４
６６: ６ ６
６７: ６ ７
６９: ６ ９
扩建: kuò jiàn
编组: biān zǔ
义民: yì mín
十三点五亿: shí sān diǎn wǔ yì
协防: xié fáng
撤回: chè huí
天文学界: tiān wén xué jiè
编纂: biān zuǎn
二日: èr rì
二时: èr shí
顶点: dǐng diǎn
Reservoir: R e s e r v o i r
盗卖: dào mài
对付: duì fù
初学: chū xué
p.: p .
兰州: lán zhōu
植物人: zhí wù rén
决心: jué xīn
志书: zhì shū
’９８: ’ ９ ８
初审: chū shěn
后面: hòu miàn
环岛: huán dǎo
嘉陵江: jiā líng jiāng
滴到: dī dào
奶瓶: nǎi píng
纽法默: niǔ fǎ mò
情杀: qíng shā
录音: lù yīn
升等: shēng děng
周宗敏: zhōu zōng mǐn
筹设: chóu shè
社交: shè jiāo
战绩: zhàn jī
环快: huán kuài
物资: wù zī
武汉关: wǔ hàn guān
譬如: pì rú
羊绒: yáng róng
物质: wù zhì
念书: niàn shū
板岩: bǎn yán
田径队: tián jìng duì
木屋: mù wū
美国队: měi guó duì
急流: jí liú
闯荡: chuǎng dàng
集训: jí xùn
配戴: pèi dài
想像力: xiǎng xiàng lì
A16: A 1 6
刑罚: xíng fá
扩展: kuò zhǎn
小盘: xiǎo pán
弯腰: wān yāo
棒球棒: bàng qiú bàng
Makine: M a k i n e
跟随: gēn suí
进修: jìn xiū
摇篮: yáo lán
权威: quán wēi
咨询: zī xún
８．７６: ８ ． ７ ６
梦到: mèng dào
带状: dài zhuàng
忠仁: zhōng rén
公用: gōng yòng
原文: yuán wén
麦棠源: mài táng yuán
灭顶: miè dǐng
潮湿: cháo shī
减缓: jiǎn huǎn
can: c a n
坦桑: tǎn sāng
规劝: guī quàn
周宗欣: zhōu zōng xīn
补习: bǔ xí
程铁生: chéng tiě shēng
吊环: diào huán
近者: jìn zhě
忠心耿耿: zhōng xīn gěng gěng
端阳: duān yáng
办学: bàn xué
联产: lián chǎn
叙利: xù lì
沐风: mù fēng
武侠: wǔ xiá
ＥＶＢＬＩＮ: Ｅ Ｖ Ｂ Ｌ Ｉ Ｎ
献唱: xiàn chàng
决口: jué kǒu
四十四亿: sì shí sì yì
装置品: zhuāng zhì pǐn
二楼: èr lóu
急急: jí jí
生力军: shēng lì jūn
固执: gù zhí
如下: rú xià
徐四民: xú sì mín
如东: rú dōng
衬衫: chèn shān
情欲: qíng yù
寿命: shòu mìng
进步: jìn bù
茶香: chá xiāng
始终: shǐ zhōng
原来: yuán lái
蜜糖: mì táng
座座: zuò zuò
潮汛: cháo xùn
翻译者: fān yì zhě
小篆: xiǎo zhuàn
职等: zhí děng
扩充: kuò chōng
如今: rú jīn
国策: guó cè
木偶: mù ǒu
深邃: shēn suì
树丛: shù cóng
起点: qǐ diǎn
营销: yíng xiāo
蠢蛋: chǔn dàn
兰卫: lán wèi
深入人心: shēn rù rén xīn
鲣鱼: jiān yú
安徽: ān huī
鱼酥店: yú sū diàn
潮流: cháo liú
公益: gōng yì
决出: jué chū
杰出: jié chū
孤独: gū dú
死死: sǐ sǐ
闯进: chuǎng jìn
胡宏伟: hú hóng wěi
来临: lái lín
国宾馆: guó bīn guǎn
办妥: bàn tuǒ
善後: shàn hòu
宋镇远: sòng zhèn yuǎn
２００亿: ２ ０ ０ yì
三芝乡: sān zhī xiāng
玛利亚: mǎ lì yà
保存法: bǎo cún fǎ
善心: shàn xīn
证书: zhèng shū
公然: gōng rán
１．６７１７: １ ． ６ ７ １ ７
总额: zǒng é
毕业生: bì yè shēng
恪遵: kè zūn
二十五点二四亿: èr shí wǔ diǎn èr sì yì
书面: shū miàn
邦交: bāng jiāo
店门口: diàn mén kǒu
圆鼓鼓: yuán gǔ gǔ
颠峰: diān fēng
饭馆: fàn guǎn
消费者: xiāo fèi zhě
战略: zhàn lüè
颗粒状: kē lì zhuàng
进阶: jìn jiē
阳城乡: yáng chéng xiāng
穷富: qióng fù
宜人: yí rén
贩卖: fàn mài
Taiwan: T a i w a n
闪动: shǎn dòng
Wal-Mart: W a l - M a r t
书院: shū yuàn
１０亿: １ ０ yì
张克千: zhāng kè qiān
1952: 1 9 5 2
雾林带: wù lín dài
刘卫东: liú wèi dōng
二滩: èr tān
界线: jiè xiàn
巧手: qiǎo shǒu
外星人: wài xīng rén
林贝聿嘉: lín bèi yù jiā
深锁: shēn suǒ
颗粒: kē lì
外环: wài huán
安装: ān zhuāng
建交: jiàn jiāo
FASHION: F A S H I O N
Agricultural: A g r i c u l t u r a l
小美: xiǎo měi
四十五点五亿: sì shí wǔ diǎn wǔ yì
熄灭: xī miè
杨佩佩: yáng pèi pèi
Jenny: J e n n y
国统: guó tǒng
丫环: yā huán
骏马: jùn mǎ
义民庙: yì mín miào
秀苗: xiù miáo
营建业: yíng jiàn yè
欢歌: huān gē
小组: xiǎo zǔ
紧肤: jǐn fū
短讯: duǎn xùn
引伸: yǐn shēn
再生产: zài shēng chǎn
国际型: guó jì xíng
初出: chū chū
沉静: chén jìng
新锐: xīn ruì
出来: chū lái
吸纳: xī nà
稳固: wěn gù
SPA: S P A
callin: c a l l i n
制药: zhì yào
二十亿: èr shí yì
二十二: èr shí èr
tamsui: t a m s u i
二十五: èr shí wǔ
业界: yè jiè
远者: yuǎn zhě
美美: měi měi
储罐: chǔ guàn
萨苏: sà sū
建设工业用: jiàn shè gōng yè yòng
德国队: dé guó duì
挥击: huī jī
联赛杯: lián sài bēi
画质: huà zhì
帐目: zhàng mù
二十三: èr shí sān
新闻: xīn wén
浓烈: nóng liè
检警: jiǎn jǐng
访求: fǎng qiú
嗓音: sǎng yīn
铝业: lǚ yè
变法: biàn fǎ
沃特卢: wò tè lú
新钞: xīn chāo
○．四: ○ ． sì
77.7: 7 7 . 7
伤残人: shāng cán rén
蒸出: zhēng chū
检讨: jiǎn tǎo
开矿: kāi kuàng
三弦: sān xián
牵挂: qiān guà
欧亚: ōu yà
三峡: sān xiá
孤岛: gū dǎo
改选: gǎi xuǎn
改送: gǎi sòng
掌权者: zhǎng quán zhě
顾耀铭: gù yào míng
劝业: quàn yè
对手: duì shǒu
６７８: ６ ７ ８
装设: zhuāng shè
群伦: qún lún
弱点: ruò diǎn
欧肇基: ōu zhào jī
菱形: líng xíng
魅力: mèi lì
拐杖: guǎi zhàng
警犬们: jǐng quǎn men
杨惠德: yáng huì dé
阉鸡鸡: yān jī jī
牵手: qiān shǒu
辛酸: xīn suān
资质证: zī zhì zhèng
始克: shǐ kè
检视: jiǎn shì
VCD: V C D
150.08: 1 5 0 . 0 8
苗木: miáo mù
停工: tíng gōng
三彩器: sān cǎi qì
蘑菇云: mó gū yún
水资源: shuǐ zī yuán
黄村: huáng cūn
龙永图: lóng yǒng tú
陈孟阳: chén mèng yáng
安东街: ān dōng jiē
饰品: shì pǐn
士绅: shì shēn
简陋: jiǎn lòu
擅自: shàn zì
统舱: tǒng cāng
洪维健: hóng wéi jiàn
寂寞: jì mò
老板娘: lǎo bǎn niáng
入狱: rù yù
出手: chū shǒu
飞利浦: fēi lì pǔ
撑破: chēng pò
锦鲤: jǐn lǐ
赋权: fù quán
070: 0 7 0
珍珠粉: zhēn zhū fěn
Levi's: L e v i ' s
谢谢: xiè xiè
鱼辣: yú là
４．５: ４ ． ５
宋版: sòng bǎn
陈东升: chén dōng shēng
五星级: wǔ xīng jí
三十三点五: sān shí sān diǎn wǔ
水电业: shuǐ diàn yè
办理: bàn lǐ
睡袋: shuì dài
破四旧: pò sì jiù
赔偿: péi cháng
铁针: tiě zhēn
MP3: M P 3
爱恋: ài liàn
遍布: biàn bù
稳健: wěn jiàn
丝瓜: sī guā
廿四日: niàn sì rì
ｗｗｗ·ｃｏｕｎｓｅｌ－ｃｈｉｎａ·ｃｏｍ: ｗ ｗ ｗ · ｃ ｏ ｕ ｎ ｓ ｅ ｌ － ｃ ｈ ｉ ｎ ａ · ｃ ｏ ｍ
水污染: shuǐ wū rǎn
布面: bù miàn
出息: chū xī
安玻人: ān bō rén
23380861: 2 3 3 8 0 8 6 1
山村: shān cūn
抓获: zhuā huò
鱼货: yú huò
１０日: １ ０ rì
山林: shān lín
试算: shì suàn
杀人灭口: shā rén miè kǒu
芬芳: fēn fāng
下山宏: xià shān hóng
双氧水: shuāng yǎng shuǐ
千秋: qiān qiū
文笔: wén bǐ
巴蜀: bā shǔ
99: 9 9
98: 9 8
铁门: tiě mén
男生: nán shēng
刘水玉: liú shuǐ yù
拳战: quán zhàn
拨交: bō jiāo
美眉: měi méi
92: 9 2
锋面: fēng miàn
陈耀邦: chén yào bāng
８７９６: ８ ７ ９ ６
卖点: mài diǎn
记录: jì lù
篇篇: piān piān
低阶: dī jiē
拨付: bō fù
制订: zhì dìng
入罪: rù zuì
sign: s i g n
匆匆: cōng cōng
鱼苗: yú miáo
书法界: shū fǎ jiè
入网: rù wǎng
环保署: huán bǎo shǔ
抓到: zhuā dào
做出: zuò chū
亚洲人: yà zhōu rén
记忆: jì yì
制证: zhì zhèng
渗入: shèn rù
花朵: huā duǒ
推选: tuī xuǎn
花木: huā mù
粮米: liáng mǐ
记帐: jì zhàng
老迈: lǎo mài
热水瓶: rè shuǐ píng
律法: lǜ fǎ
PUB: P U B
回乡: huí xiāng
爱尔兰箫: ài ěr lán xiāo
出满: chū mǎn
津巴布韦: jīn bā bù wéi
低音: dī yīn
230: 2 3 0
巴西: bā xī
西谚: xī yàn
s3: s 3
瞄准: miáo zhǔn
拳手: quán shǒu
日报社: rì bào shè
球友们: qiú yǒu men
测试: cè shì
花旗: huā qí
继续: jì xù
出海: chū hǎi
文盲: wén máng
检考: jiǎn kǎo
预付: yù fù
２４日: ２ ４ rì
谢荣: xiè róng
改飞: gǎi fēi
１７２: １ ７ ２
１７１: １ ７ １
检肃: jiǎn sù
飞翔: fēi xiáng
计较: jì jiào
现代版: xiàn dài bǎn
全日制: quán rì zhì
螺钱贝: luó qián bèi
8504: 8 5 0 4
辉煌: huī huáng
滞后: zhì hòu
防范: fáng fàn
师范: shī fàn
飘倏: piāo shū
勃动: bó dòng
业绩: yè jī
Qingming: Q i n g m i n g
诱人: yòu rén
申银: shēn yín
制衡: zhì héng
规范: guī fàn
山歌: shān gē
授课: shòu kè
遍及: biàn jí
铁饼: tiě bǐng
锥炉: zhuī lú
陈辉龙: chén huī lóng
付费: fù fèi
庐山: lú shān
学来: xué lái
制裁: zhì cái
聚酯丝: jù zhǐ sī
领导人: lǐng dǎo rén
２０１６: ２ ０ １ ６
２０００亿: ２ ０ ０ ０ yì
目录: mù lù
山水: shān shuǐ
晚报: wǎn bào
周德孚: zhōu dé fú
财产权: cái chǎn quán
星友: xīng yǒu
购屋人: gòu wū rén
山河: shān hé
丝线: sī xiàn
ＢＯＴ: Ｂ Ｏ Ｔ
西西: xī xī
丝织: sī zhī
试烧: shì shāo
媳妇: xí fù
丝绳: sī shéng
浏览: liú lǎn
惠州: huì zhōu
丝绸: sī chóu
产业界: chǎn yè jiè
三叔: sān shū
稳定: wěn dìng
远距: yuǎn jù
遏止: è zhǐ
砍伐史: kǎn fá shǐ
产业用: chǎn yè yòng
新页: xīn yè
纱线: shā xiàn
付诸: fù zhū
西装: xī zhuāng
统计: tǒng jì
新颖: xīn yǐng
凶悍: xiōng hàn
三十: sān shí
三千: sān qiān
笨拙: bèn zhuō
飘然: piāo rán
形象: xíng xiàng
林则徐: lín zé xú
远赴: yuǎn fù
远走: yuǎn zǒu
推销: tuī xiāo
盗贼: dào zéi
品尝: pǐn cháng
拥护者: yōng hù zhě
随俗: suí sú
起死回生: qǐ sǐ huí shēng
常香玉: cháng xiāng yù
马尔默队: mǎ ěr mò duì
kennex: k e n n e x
低速: dī sù
kolf: k o l f
老街: lǎo jiē
学成: xué chéng
文物: wén wù
棘手: jí shǒu
考验: kǎo yàn
防蛀: fáng zhù
项链: xiàng liàn
山下人: shān xià rén
邦交国: bāng jiāo guó
淄博: zī bó
译成: yì chéng
三军: sān jūn
远远: yuǎn yuǎn
替补: tì bǔ
CD版: C D bǎn
庞然: páng rán
保卫: bǎo wèi
稳妥: wěn tuǒ
撞进: zhuàng jìn
周锡生: zhōu xī shēng
变成: biàn chéng
三兆: sān zhào
三公: sān gōng
忠君爱国: zhōng jūn ài guó
ＢＰ: Ｂ Ｐ
独门: dú mén
文献: wén xiàn
突飞猛进: tū fēi měng jìn
黄河: huáng hé
文法: wén fǎ
征求: zhēng qiú
停业: tíng yè
杨吉雄: yáng jí xióng
寄托: jì tuō
停下: tíng xià
tw: t w
to: t o
巴郡: bā jùn
三亚: sān yà
热心: rè xīn
坚毅: jiān yì
三五: sān wǔ
因势利导: yīn shì lì dǎo
三亿: sān yì
三点五五亿: sān diǎn wǔ wǔ yì
攻防战: gōng fáng zhàn
装饰: zhuāng shì
三产: sān chǎn
富士: fù shì
谆谆: zhūn zhūn
小贩: xiǎo fàn
停产: tíng chǎn
University: U n i v e r s i t y
检验: jiǎn yàn
吸湿: xī shī
绢布: juàn bù
３４２·６０: ３ ４ ２ · ６ ０
黄牌: huáng pái
群峦: qún luán
星云: xīng yún
３７０多: ３ ７ ０ duō
周四: zhōu sì
阴沉: yīn chén
毅然: yì rán
停伫: tíng zhù
宝惜: bǎo xī
普莱赛: pǔ lái sài
群岛: qún dǎo
杨维成: yáng wéi chéng
罹患: lí huàn
悠悠: yōu yōu
求变: qiú biàn
热带: rè dài
股民: gǔ mín
兵马俑: bīng mǎ yǒng
组办: zǔ bàn
回国: huí guó
恩断义绝: ēn duàn yì jué
输出: shū chū
组党: zǔ dǎng
先驱: xiān qū
贫农: pín nóng
Tsengwen: T s e n g w e n
环保日: huán bǎo rì
预算案: yù suàn àn
热工: rè gōng
阵阵: zhèn zhèn
飙到: biāo dào
碳素: tàn sù
飞来: fēi lái
满天飞: mǎn tiān fēi
业权: yè quán
随即: suí jí
输入: shū rù
ㄅㄆㄇ: ㄅ ㄆ ㄇ
生产型: shēng chǎn xíng
薛志扬: xuē zhì yáng
男性: nán xìng
范文欣: fàn wén xīn
张润生: zhāng rùn shēng
西面: xī miàn
二十四日: èr shí sì rì
鞍马: ān mǎ
飙升: biāo shēng
１１．７２: １ １ ． ７ ２
二０００: èr ０ ０ ０
巫婆: wū pó
邮寄: yóu jì
花粉: huā fěn
阶层: jiē céng
诱因: yòu yīn
构建: gòu jiàn
宝成: bǎo chéng
西陵: xī líng
回响: huí xiǎng
盆盆: pén pén
申诉: shēn sù
申请: shēn qǐng
花鼓队: huā gǔ duì
回升: huí shēng
建设史: jiàn shè shǐ
雄心: xióng xīn
讲出: jiǎng chū
猖獗: chāng jué
邮局: yóu jú
盐湖: yán hú
出现: chū xiàn
历练: lì liàn
1.66: 1 . 6 6
建设厅: jiàn shè tīng
执笔人: zhí bǐ rén
黑龙江: hēi lóng jiāng
出版: chū bǎn
回到: huí dào
寄来: jì lái
画风: huà fēng
寄望: jì wàng
71.93: 7 1 . 9 3
出狱: chū yù
入手: rù shǒu
费心: fèi xīn
对谈者: duì tán zhě
新股: xīn gǔ
河砾层: hé lì céng
珍宝: zhēn bǎo
预先: yù xiān
Itaru: I t a r u
随后: suí hòu
疗伤: liáo shāng
获奖: huò jiǎng
杨庆文: yáng qìng wén
展现: zhǎn xiàn
林口乡: lín kǒu xiāng
东森: dōng sēn
真确性: zhēn què xìng
pali: p a l i
丈人: zhàng rén
ACC: A C C
生命表: shēng mìng biǎo
每况愈下: měi kuàng yù xià
公私帐: gōng sī zhàng
UPS: U P S
巫师: wū shī
变窄: biàn zhǎi
剪辑: jiǎn jí
６．９４亿: ６ ． ９ ４ yì
推进: tuī jìn
推迟: tuī chí
云层: yún céng
龙凤: lóng fèng
根基: gēn jī
飞扬: fēi yáng
肤质: fū zhì
入息: rù xī
费工: fèi gōng
生产力: shēng chǎn lì
29.50: 2 9 . 5 0
出炉: chū lú
围堰: wéi yàn
二十多: èr shí duō
围城: wéi chéng
ＤＡＸ: Ｄ Ａ Ｘ
新贵: xīn guì
二十四: èr shí sì
装配: zhuāng pèi
回归: huí guī
记住: jì zhù
久旱: jiǔ hàn
坚持: jiān chí
文摘: wén zhāi
BABOO: B A B O O
测验: cè yàn
加紧: jiā jǐn
雄厚: xióng hòu
费力: fèi lì
花盆: huā pén
求学: qiú xué
１８·６亿: １ ８ · ６ yì
甥舅: shēng jiù
及时: jí shí
简讯: jiǎn xùn
文旦: wén dàn
及早: jí zǎo
拳坛: quán tán
63.1: 6 3 . 1
蛋挞店: dàn tà diàn
回府: huí fǔ
学生: xué shēng
开然林: kāi rán lín
奢求: shē qiú
征文: zhēng wén
松山: sōng shān
出线: chū xiàn
云动: yún dòng
求实: qiú shí
老鼠: lǎo shǔ
死灰复燃: sǐ huī fù rán
富农: fù nóng
学界: xué jiè
丝毫: sī háo
李茂": lǐ mào "
棘皮: jí pí
５０４０．１５: ５ ０ ４ ０ ． １ ５
雄关: xióng guān
９２２６．７５: ９ ２ ２ ６ ． ７ ５
阴柔: yīn róu
摆开: bǎi kāi
铁皮屋: tiě pí wū
词汇: cí huì
紫荆: zǐ jīng
ABC: A B C
胡天国: hú tiān guó
改装: gǎi zhuāng
股条: gǔ tiáo
世世代代: shì shì dài dài
股权: gǔ quán
珍品: zhēn pǐn
花瓶: huā píng
花瓣: huā bàn
鄙俗: bǐ sú
订货: dìng huò
订购: dìng gòu
物品: wù pǐn
58.40: 5 8 . 4 0
灰黑: huī hēi
考进: kǎo jìn
吸收: xī shōu
洛阳: luò yáng
西屋: xī wū
编制: biān zhì
樱花: yīng huā
李亚飞: lǐ yà fēi
毅然决然: yì rán jué rán
紫薇: zǐ wēi
学生们: xué shēng men
试想: shì xiǎng
第１５: dì １ ５
第１０: dì １ ０
第１３: dì １ ３
东帝士: dōng dì shì
国防法: guó fáng fǎ
卖断: mài duàn
铜雕: tóng diāo
贝桑: bèi sāng
装置性: zhuāng zhì xìng
获利: huò lì
浓浓: nóng nóng
丹东: dān dōng
Kaoping: K a o p i n g
预备: yù bèi
62.3: 6 2 . 3
士林: shì lín
改进: gǎi jìn
组建: zǔ jiàn
资迅人: zī xùn rén
铜陵: tóng líng
－－: － －
欧元: ōu yuán
骑兵: qí bīng
巴黎: bā lí
回复: huí fù
叠嶂: dié zhàng
决算: jué suàn
变现: biàn xiàn
宣扬: xuān yáng
统领: tǒng lǐng
养成所: yǎng chéng suǒ
纺织业: fǎng zhī yè
随後: suí hòu
陈美凤: chén měi fèng
琵琶: pí pá
撑持: chēng chí
师院: shī yuàn
甲午战: jiǎ wǔ zhàn
殡仪馆: bìn yí guǎn
获准: huò zhǔn
生物群: shēng wù qún
飘扬: piāo yáng
帐棚: zhàng péng
晦暗: huì àn
彪炳: biāo bǐng
预定: yù dìng
撑托: chēng tuō
老屋: lǎo wū
验证: yàn zhèng
壮严: zhuàng yán
铜铸: tóng zhù
考证: kǎo zhèng
老饕: lǎo tāo
获悉: huò xī
考试: kǎo shì
牵线: qiān xiàn
延揽: yán lǎn
碳烤: tàn kǎo
院线: yuàn xiàn
俯视: fǔ shì
畦畦: qí qí
拳击: quán jī
纯真: chún zhēn
７４７: ７ ４ ７
沦陷: lún xiàn
坚实: jiān shí
坚定: jiān dìng
品牌: pǐn pái
农业人: nóng yè rén
特力屋: tè lì wū
求战: qiú zhàn
三线: sān xiàn
Ｃ－１３０: Ｃ － １ ３ ０
回来: huí lái
刮起: guā qǐ
就近: jiù jìn
３３９·１２: ３ ３ ９ · １ ２
文山: wén shān
138.69: 1 3 8 . 6 9
加工出口型: jiā gōng chū kǒu xíng
利诱: lì yòu
披萨皮: pī sà pí
热潮: rè cháo
弱势: ruò shì
国学: guó xué
胡楚生: hú chǔ shēng
旅顺口: lǚ shùn kǒu
飞向: fēi xiàng
亚洲杯: yà zhōu bēi
入围: rù wéi
捕鱼用: bǔ yú yòng
轶文: yì wén
男友: nán yǒu
星级: xīng jí
澜沧江: lán cāng jiāng
三美: sān měi
组成: zǔ chéng
ICCAT: I C C A T
欧洲: ōu zhōu
二十多亿: èr shí duō yì
滞纳: zhì nà
爬到: pá dào
吸引: xī yǐn
随性: suí xìng
花丝: huā sī
花东: huā dōng
生存权: shēng cún quán
２４亿: ２ ４ yì
杰富利: jié fù lì
戴龙岳: dài lóng yuè
学人: xué rén
张则周: zhāng zé zhōu
宣布: xuān bù
回收: huí shōu
宣帝: xuān dì
饰物: shì wù
带出: dài chū
面试: miàn shì
官兵: guān bīng
扬雄: yáng xióng
劳保: láo bǎo
千岁: qiān suì
芳心: fāng xīn
疗养院: liáo yǎng yuàn
学业: xué yè
关帝爷: guān dì yé
挞伐: tà fá
文帝: wén dì
美工: měi gōng
学习: xué xí
实验性: shí yàn xìng
created: c r e a t e d
在座: zài zuò
９.７８: ９ . ７ ８
寄养: jì yǎng
热河: rè hé
胡泰然: hú tài rán
紧跟: jǐn gēn
展览: zhǎn lǎn
飘忽: piāo hū
紧贴: jǐn tiē
浓厚: nóng hòu
随手: suí shǒu
林肯: lín kěn
寄出: jì chū
报酬: bào chóu
飞回: fēi huí
迪拜: dí bài
李安定: lǐ ān dìng
入口: rù kǒu
随时: suí shí
目睹: mù dǔ
美学: měi xué
拨拨: bō bō
自生自灭: zì shēng zì miè
预想: yù xiǎng
阶段: jiē duàn
习画: xí huà
妈阁: mā gé
多伦多: duō lún duō
独独: dú dú
停滞: tíng zhì
五点二亿: wǔ diǎn èr yì
we: w e
刘耀东: liú yào dōng
热歌: rè gē
卖屋: mài wū
生产性: shēng chǎn xìng
粮农: liáng nóng
企图心: qǐ tú xīn
签证: qiān zhèng
签订: qiān dìng
回扣: huí kòu
菜圃: cài pǔ
缜密: zhěn mì
因特网: yīn tè wǎng
构树: gòu shù
话音: huà yīn
面谈: miàn tán
回报: huí bào
党证: dǎng zhèng
Dataplay: D a t a p l a y
３５４·３９: ３ ５ ４ · ３ ９
卖座: mài zuò
预报: yù bào
宾馆: bīn guǎn
杀人犯: shā rén fàn
电脑: diàn nǎo
李庆安: lǐ qìng ān
谭惠珠: tán huì zhū
飞升: fēi shēng
产业带: chǎn yè dài
1976: 1 9 7 6
连锁店: lián suǒ diàn
世俗: shì sú
入关: rù guān
药费: yào fèi
送递: sòng dì
１１: １ １
１０: １ ０
１３: １ ３
１２: １ ２
１５: １ ５
１７: １ ７
１６: １ ６
１９: １ ９
１８: １ ８
跟风: gēn fēng
飞到: fēi dào
罗马: luó mǎ
丹瑞: dān ruì
老K: lǎo K
文官: wén guān
建设性: jiàn shè xìng
热线: rè xiàn
桌球队: zhuō qiú duì
业务: yè wù
文宣: wén xuān
文字: wén zì
生师: shēng shī
VS.: V S .
炫目: xuàn mù
文学: wén xué
安汉公: ān hàn gōng
引导性: yǐn dǎo xìng
宏伟: hóng wěi
求新: qiú xīn
公元: gōng yuán
面膜: miàn mó
茶顶: chá dǐng
归向: guī xiàng
苏德新: sū dé xīn
男婴: nán yīng
喂饱: wèi bǎo
伫望: zhù wàng
邮电业: yóu diàn yè
茶风: chá fēng
Rivers: R i v e r s
贝尔: bèi ěr
出书: chū shū
寄存: jì cún
出乎: chū hū
阶级: jiē jí
存货: cún huò
欧文: ōu wén
ＮＴ: Ｎ Ｔ
海洛因: hǎi luò yīn
入库: rù kù
二十来: èr shí lái
男孩: nán hái
赔罪: péi zuì
瞄向: miáo xiàng
品管: pǐn guǎn
农耕队: nóng gēng duì
图集: tú jí
预测: yù cè
出产: chū chǎn
美国: měi guó
史学界: shǐ xué jiè
新四军: xīn sì jūn
贺海钧: hè hǎi jūn
深加工业: shēn jiā gōng yè
宝宝: bǎo bǎo
男士: nán shì
第五十二: dì wǔ shí èr
邮报: yóu bào
输出国: shū chū guó
药膳: yào shàn
坚决: jiān jué
生徒: shēng tú
富户: fù hù
1951: 1 9 5 1
1950: 1 9 5 0
回流: huí liú
羯鼓: jié gǔ
电费: diàn fèi
栋栋: dòng dòng
美商: měi shāng
跃跃欲试: yuè yuè yù shì
第五十三: dì wǔ shí sān
杀手级: shā shǒu jí
鲍威尔: bào wēi ěr
卖到: mài dào
碗装: wǎn zhuāng
试图: shì tú
梵谛冈: fàn dì gāng
话题: huà tí
五佳: wǔ jiā
嘉庆: jiā qìng
飞快: fēi kuài
河口湖: hé kǒu hú
二十日: èr shí rì
停电: tíng diàn
老婆: lǎo pó
患者: huàn zhě
二军: èr jūn
心肝宝贝: xīn gān bǎo bèi
灵性: líng xìng
喂药: wèi yào
士兵: shì bīng
栏目: lán mù
文坛: wén tán
攻防: gōng fáng
宣城: xuān chéng
恩戈兰: ēn gē lán
环保局: huán bǎo jú
屋宇署: wū yǔ shǔ
迂回: yū huí
飞天: fēi tiān
争议性: zhēng yì xìng
云朵: yún duǒ
腹案: fù àn
入室: rù shì
试做: shì zuò
电话: diàn huà
入学: rù xué
保卫战: bǎo wèi zhàn
Study: S t u d y
云林: yún lín
稳稳: wěn wěn
电讯: diàn xùn
输出值: shū chū zhí
征兆: zhēng zhào
陡峭: dǒu qiào
宝岛: bǎo dǎo
准新人: zhǔn xīn rén
文函: wén hán
文凭: wén píng
千千: qiān qiān
利马窦: lì mǎ dòu
三环: sān huán
构想: gòu xiǎng
美劳: měi láo
热战: rè zhàn
沪铜: hù tóng
密林: mì lín
３．６８亿: ３ ． ６ ８ yì
试出: shì chū
围成: wéi chéng
聪慧: cōng huì
型态: xíng tài
宝山: bǎo shān
山丘: shān qiū
山东: shān dōng
宣判: xuān pàn
酗酒: xù jiǔ
飘动: piāo dòng
□袋: □ dài
凶手: xiōng shǒu
飘飘人: piāo piāo rén
护肤: hù fū
躲进: duǒ jìn
欧巴桑: ōu bā sāng
74: 7 4
三点: sān diǎn
算命师: suàn mìng shī
美元: měi yuán
品类: pǐn lèi
试剂: shì jì
玛嘉烈: mǎ jiā liè
Marc: M a r c
後继者: hòu jì zhě
电视: diàn shì
自然人: zì rán rén
试办: shì bàn
制帽: zhì mào
美军: měi jūn
山产: shān chǎn
人脑: rén nǎo
弊案: bì àn
入夜: rù yè
珍惜: zhēn xī
劳基法: láo jī fǎ
闻到: wén dào
宝库: bǎo kù
宝府: bǎo fǔ
芝加哥: zhī jiā gē
潜逃: qián táo
文友: wén yǒu
就职: jiù zhí
文史: wén shǐ
腐烂: fǔ làn
宝座: bǎo zuò
热情: rè qíng
入境: rù jìng
构成: gòu chéng
费时: fèi shí
78: 7 8
吸入: xī rù
５５: ５ ５
５４: ５ ４
５７: ５ ７
５０: ５ ０
爬山: pá shān
跟进: gēn jìn
退耕: tuì gēng
诟病: gòu bìng
辩护: biàn hù
糕饼: gāo bǐng
退职: tuì zhí
８６３亿: ８ ６ ３ yì
胃口: wèi kǒu
围网: wéi wǎng
退股: tuì gǔ
千亿: qiān yì
劳工: láo gōng
黄历: huáng lì
潜进: qián jìn
微微: wēi wēi
５．６亿: ５ ． ６ yì
谢尔博: xiè ěr bó
素材: sù cái
面额: miàn é
美专: měi zhuān
利马: lì mǎ
变小: biàn xiǎo
出国: chū guó
美人: měi rén
变局: biàn jú
织起: zhī qǐ
现买现卖: xiàn mǎi xiàn mài
躲避: duǒ bì
跟踪: gēn zōng
挥挥: huī huī
二十点五: èr shí diǎn wǔ
劳役: láo yì
攻进: gōng jìn
学府: xué fǔ
回收箱: huí shōu xiāng
群群: qún qún
陈进军: chén jìn jūn
国小: guó xiǎo
染黑: rǎn hēi
骆驼: luò tuó
文人: wén rén
成交值: chéng jiāo zhí
宋美龄: sòng měi líng
延误: yán wù
文义: wén yì
突破口: tū pò kǒu
Marten: M a r t e n
报考: bào kǎo
文书: wén shū
总编辑: zǒng biān jí
变形: biàn xíng
三水: sān shuǐ
晓雯: xiǎo wén
１６００亿: １ ６ ０ ０ yì
牵制: qiān zhì
Copyright: C o p y r i g h t
邮简: yóu jiǎn
图象: tú xiàng
钦赐: qīn cì
步入: bù rù
捕鱼权: bǔ yú quán
弊病: bì bìng
挥手: huī shǒu
在职生: zài zhí shēng
利益: lì yì
牵动: qiān dòng
漾出: yàng chū
山友: shān yǒu
变幻: biàn huàn
遏制: è zhì
融资: róng zī
出卖: chū mài
学士: xué shì
跟访: gēn fǎng
诸如: zhū rú
崇拜: chóng bài
出口: chū kǒu
变多: biàn duō
晚婚: wǎn hūn
吕文德: lǚ wén dé
诸多: zhū duō
TMD: T M D
企鹅: qǐ é
林阳: lín yáng
晚宴: wǎn yàn
TALK: T A L K
铠甲: kǎi jiǎ
龙珠: lóng zhū
在职班: zài zhí bān
停止: tíng zhǐ
２．５: ２ ． ５
社讯: shè xùn
Teen: T e e n
31.79: 3 1 . 7 9
梅特涅: méi tè niè
叔叔: shū shū
迪特尔·鲍曼: dí tè ěr · bào màn
人马: rén mǎ
出动: chū dòng
疗法: liáo fǎ
凋弊: diāo bì
五千亿: wǔ qiān yì
出入: chū rù
出兵: chū bīng
出具: chū jù
出关: chū guān
现代人: xiàn dài rén
密晤: mì wù
千岛湖: qiān dǎo hú
攻讦: gōng jié
匈奴: xiōng nú
股东: gǔ dōng
挥杖: huī zhàng
II型: I I xíng
Ａ股: Ａ gǔ
出击: chū jī
资产额: zī chǎn é
延迟: yán chí
图表: tú biǎo
９８: ９ ８
基层: jī céng
９１: ９ １
９０: ９ ０
９５: ９ ５
９７: ９ ７
珍珠丸: zhēn zhū wán
２９０: ２ ９ ０
尖山湖: jiān shān hú
天丝棉: tiān sī mián
山坡: shān pō
出借: chū jiè
珍禽: zhēn qín
邮编: yóu biān
文伦: wén lún
02: 0 2
领航者: lǐng háng zhě
花城: huā chéng
陈希煌: chén xī huáng
诺贝尔奖: nuò bèi ěr jiǎng
筛选: shāi xuǎn
生出: shēng chū
欣欣向荣: xīn xīn xiàng róng
箭镞: jiàn zú
词人: cí rén
收录: shōu lù
三星: sān xīng
花圃: huā pǔ
协议额: xié yì é
捕鱼法: bǔ yú fǎ
征管法: zhēng guǎn fǎ
丑闻: chǒu wén
送进: sòng jìn
杨孙西: yáng sūn xī
扬起: yáng qǐ
宇宙: yǔ zhòu
星星: xīng xīng
获益: huò yì
人际: rén jì
入出境: rù chū jìng
逝世: shì shì
四十二亿: sì shí èr yì
停摆: tíng bǎi
翡翠: fěi cuì
攻击性: gōng jī xìng
1981: 1 9 8 1
满目疮痍: mǎn mù chuāng yí
随笔: suí bǐ
礼让: lǐ ràng
黄秋葵: huáng qiū kuí
三时: sān shí
张毅君: zhāng yì jūn
三日: sān rì
Remote: R e m o t e
目标: mù biāo
联检: lián jiǎn
亚热带: yà rè dài
生产线: shēng chǎn xiàn
送赠: sòng zèng
退让: tuì ràng
送走: sòng zǒu
赌博: dǔ bó
文宣营: wén xuān yíng
停时: tíng shí
送货: sòng huò
律师: lǜ shī
叔婶: shū shěn
偷袭: tōu xí
停战: tíng zhàn
珍爱: zhēn ài
厚葬: hòu zàng
轻舟: qīng zhōu
１０６２: １ ０ ６ ２
花季: huā jì
疗效: liáo xiào
陈骏麟: chén jùn lín
男人: nán rén
弊端: bì duān
花卉: huā huì
山岳: shān yuè
纺织法: fǎng zhī fǎ
三成: sān chéng
避险: bì xiǎn
山峦: shān luán
实实在在: shí shí zài zài
山崖: shān yá
退货: tuì huò
回稳: huí wěn
送请: sòng qǐng
星报: xīng bào
鲍佳慧: bào jiā huì
五十多亿: wǔ shí duō yì
五十三亿: wǔ shí sān yì
爬下: pá xià
礼贤: lǐ xián
急功近利: jí gōng jìn lì
沪蓉: hù róng
西生菜: xī shēng cài
邮电: yóu diàn
稳步: wěn bù
珍珠: zhēn zhū
挥泪: huī lèi
山川: shān chuān
林黛: lín dài
紫荆花: zǐ jīng huā
礼赞: lǐ zàn
苗天: miáo tiān
图腾: tú téng
牵引: qiān yǐn
宏图: hóng tú
宏国: hóng guó
杰克逊: jié kè xùn
顶罟村: dǐng gǔ cūn
花农: huā nóng
疏忽: shū hū
出外: chū wài
访友: fǎng yǒu
面霜: miàn shuāng
045: 0 4 5
044: 0 4 4
040: 0 4 0
托管人: tuō guǎn rén
宏基: hóng jī
预算: yù suàn
粗窟村: cū kū cūn
变动: biàn dòng
１８．６８: １ ８ ． ６ ８
学历: xué lì
四川队: sì chuān duì
热点: rè diǎn
李聪菘: lǐ cōng sōng
黄山: huáng shān
费用: fèi yòng
热烈: rè liè
围炉: wéi lú
凶猛: xiōng měng
人选: rén xuǎn
展销: zhǎn xiāo
劳力: láo lì
疾驶: jí shǐ
腐性: fǔ xìng
黄岩: huáng yán
龙祥: lóng xiáng
出境: chū jìng
劳动: láo dòng
关岛: guān dǎo
沅江: yuán jiāng
涟漪: lián yī
此外: cǐ wài
拥挤: yōng jǐ
成功: chéng gōng
严肃: yán sù
送回: sòng huí
脑瘤: nǎo liú
108: 1 0 8
109: 1 0 9
102: 1 0 2
103: 1 0 3
100: 1 0 0
101: 1 0 1
106: 1 0 6
107: 1 0 7
105: 1 0 5
猛兽: měng shòu
短剧: duǎn jù
收集: shōu jí
Tanshui: T a n s h u i
孙星文: sūn xīng wén
浮出: fú chū
修饰: xiū shì
三十四亿: sān shí sì yì
瑙鲁: nǎo lǔ
褒忠: bāo zhōng
哀伤: āi shāng
协进社: xié jìn shè
常州: cháng zhōu
拥护: yōng hù
收音: shōu yīn
三人组: sān rén zǔ
覆满: fù mǎn
十三日: shí sān rì
刘廷耀: liú tíng yào
目录栏: mù lù lán
茶馀酒後: chá yú jiǔ hòu
手持: shǒu chí
夺走: duó zǒu
整整: zhěng zhěng
诊断用: zhěn duàn yòng
盔甲: kuī jiǎ
复线: fù xiàn
浮动: fú dòng
脑海: nǎo hǎi
黑人: hēi rén
常常: cháng cháng
reader: r e a d e r
进出境: jìn chū jìng
音域: yīn yù
民营: mín yíng
240: 2 4 0
收银: shōu yín
杨霞: yáng xiá
丢脸: diū liǎn
负面: fù miàn
整新: zhěng xīn
窘况: jiǒng kuàng
官阶: guān jiē
代代: dài dài
後悔: hòu huǐ
步骤: bù zhòu
１４７: １ ４ ７
１４３: １ ４ ３
志愿者: zhì yuàn zhě
雕塑: diāo sù
代书: dài shū
熊熊: xióng xióng
孙杰: sūn jié
深加工: shēn jiā gōng
李斌: lǐ bīn
二．五: èr ． wǔ
疲软: pí ruǎn
独自: dú zì
Free: F r e e
拨回: bō huí
甜水海: tián shuǐ hǎi
渡海: dù hǎi
心法: xīn fǎ
彰显: zhāng xiǎn
官邸: guān dǐ
秦汉: qín hàn
想象: xiǎng xiàng
後来: hòu lái
Central: C e n t r a l
民航: mín háng
翻修: fān xiū
７．５亿: ７ ． ５ yì
江志忠: jiāng zhì zhōng
Compact: C o m p a c t
举人: jǔ rén
影星: yǐng xīng
针线: zhēn xiàn
层面: céng miàn
闲步: xián bù
阎涛: yán tāo
恩情: ēn qíng
情话绵绵: qíng huà mián mián
出海口: chū hǎi kǒu
想起: xiǎng qǐ
湖潮: hú cháo
ＡＭＰ: Ａ Ｍ Ｐ
２１８: ２ １ ８
诉状: sù zhuàng
弘法: hóng fǎ
音像: yīn xiàng
轰动: hōng dòng
馈礼: kuì lǐ
尖兵们: jiān bīng men
胡桶: hú tǒng
敬佩: jìng pèi
永续生养: yǒng xù shēng yǎng
藤竹: téng zhú
电影院: diàn yǐng yuàn
国安局: guó ān jú
浇熄: jiāo xī
僵持: jiāng chí
此後: cǐ hòu
徭役: yáo yì
基座: jī zuò
孟军: mèng jūn
字型: zì xíng
伊军: yī jūn
酷炫: kù xuàn
幽谧: yōu mì
劫後馀生: jié hòu yú shēng
表态: biǎo tài
绑死: bǎng sǐ
周恩来: zhōu ēn lái
胡椒: hú jiāo
练习: liàn xí
时代剧: shí dài jù
Andrei: A n d r e i
马绍尔: mǎ shào ěr
互联网: hù lián wǎng
表情: biǎo qíng
寮屋: liáo wū
向日葵: xiàng rì kuí
山腰: shān yāo
交加: jiāo jiā
保荐人: bǎo jiàn rén
李渔: lǐ yú
独资: dú zī
心态: xīn tài
杨爱国: yáng ài guó
AM.: A M .
心性: xīn xìng
７０００亿: ７ ０ ０ ０ yì
驱动: qū dòng
水资局: shuǐ zī jú
定额: dìng é
交到: jiāo dào
崩盘: bēng pán
败诉: bài sù
黄苏: huáng sū
资历: zī lì
辜宽敏: gū kuān mǐn
碰面: pèng miàn
短寿: duǎn shòu
Prada: P r a d a
进出口: jìn chū kǒu
热门股: rè mén gǔ
心愿: xīn yuàn
四下: sì xià
苏杰: sū jié
捞钱: lāo qián
WTO: W T O
开悟: kāi wù
张曼玉: zhāng màn yù
９９: ９ ９
桥梁: qiáo liáng
陈晓雯: chén xiǎo wén
音律: yīn lǜ
手段: shǒu duàn
球类型: qiú lèi xíng
张世元: zhāng shì yuán
鲍佳欣: bào jiā xīn
航归: háng guī
钱潮: qián cháo
民谣: mín yáo
１８００: １ ８ ０ ０
自杀: zì shā
Levy: L e v y
三亿多: sān yì duō
动人: dòng rén
10: 1 0
13: 1 3
19: 1 9
18: 1 8
摆渡乡: bǎi dù xiāng
讲师: jiǎng shī
律动: lǜ dòng
严词: yán cí
针灸: zhēn jiǔ
张延群: zhāng yán qún
苏黎世: sū lí shì
雕像: diāo xiàng
交际: jiāo jì
严谨: yán jǐn
心理学: xīn lǐ xué
显然: xiǎn rán
成帝: chéng dì
凭悼: píng dào
丢进: diū jìn
两用: liǎng yòng
Ｓ－３００: Ｓ － ３ ０ ０
翩翩: piān piān
１．４亿: １ ． ４ yì
沉寂: chén jì
借贷: jiè dài
孙桥: sūn qiáo
起用: qǐ yòng
靠拢: kào lǒng
航天: háng tiān
货物: huò wù
轻巧: qīng qiǎo
独裁: dú cái
马克: mǎ kè
此后: cǐ hòu
成形: chéng xíng
函电: hán diàn
惨败: cǎn bài
Shipley: S h i p l e y
ＩＴＵ: Ｉ Ｔ Ｕ
手法: shǒu fǎ
成就: chéng jiù
常务: cháng wù
四千多亿: sì qiān duō yì
耿直: gěng zhí
饱尝: bǎo cháng
硕士: shuò shì
水闸: shuǐ zhá
Room: R o o m
魔鬼: mó guǐ
Dr.: D r .
３０日: ３ ０ rì
丰富多彩: fēng fù duō cǎi
公案: gōng àn
苏恺: sū kǎi
深层: shēn céng
尖兵: jiān bīng
铂铑: bó lǎo
基础性: jī chǔ xìng
峨眉乡: é méi xiāng
民视: mín shì
秦杰: qín jié
侦防: zhēn fáng
败象: bài xiàng
伊始: yī shǐ
法院: fǎ yuàn
痛心疾首: tòng xīn jí shǒu
淘汰: táo tài
满档: mǎn dàng
奉劝: fèng quàn
代工: dài gōng
货源: huò yuán
修补: xiū bǔ
质素: zhì sù
哀帝: āi dì
gov: g o v
稻米: dào mǐ
岳丰: yuè fēng
５．２６亿: ５ ． ２ ６ yì
编织袋: biān zhī dài
计画书: jì huà shū
匆匆忙忙: cōng cōng máng máng
民防: mín fáng
链球: liàn qiú
法规: fǎ guī
巍巍然: wēi wēi rán
讯息: xùn xī
严酷: yán kù
逻辑: luó jí
李秉峄: lǐ bǐng yì
表皮: biǎo pí
e世代: e shì dài
惨酷: cǎn kù
二水桥: èr shuǐ qiáo
77.15: 7 7 . 1 5
功课: gōng kè
动向: dòng xiàng
旅途: lǚ tú
翻天: fān tiān
黑帮: hēi bāng
24: 2 4
25: 2 5
20: 2 0
挪出: nuó chū
29: 2 9
尖端: jiān duān
议定书: yì dìng shū
李努尔: lǐ nǔ ěr
法警: fǎ jǐng
柯豪: kē háo
陈质枫: chén zhì fēng
义工: yì gōng
网页: wǎng yè
侦讯: zhēn xùn
常义: cháng yì
伊藤忠: yī téng zhōng
裕阳: yù yáng
动因: dòng yīn
黔江: qián jiāng
败选: bài xuǎn
来回: lái huí
吕炳川: lǚ bǐng chuān
满学杰: mǎn xué jié
生计: shēng jì
痼疾: gù jí
生词: shēng cí
整理: zhěng lǐ
耕耘: gēng yún
马修: mǎ xiū
外向型: wài xiàng xíng
停建: tíng jiàn
２３日: ２ ３ rì
耕者: gēng zhě
後现代: hòu xiàn dài
奉养: fèng yǎng
修订: xiū dìng
偏爱: piān ài
劳动密集型: láo dòng mì jí xíng
翻开: fān kāi
逃避: táo bì
交付: jiāo fù
协定: xié dìng
藤森: téng sēn
劫持: jié chí
初赛: chū sài
资产: zī chǎn
补习班: bǔ xí bān
官职: guān zhí
表现: biǎo xiàn
四千: sì qiān
四十: sì shí
天工开物: tiān gōng kāi wù
借镜: jiè jìng
退却: tuì què
人面: rén miàn
80.51: 8 0 . 5 1
启用: qǐ yòng
水轮: shuǐ lún
盘点: pán diǎn
今早: jīn zǎo
环渤海: huán bó hǎi
驱使: qū shǐ
收获: shōu huò
组织者: zǔ zhī zhě
彻夜: chè yè
生财: shēng cái
凭祥: píng xiáng
幽默: yōu mò
李灿: lǐ càn
莲峰庙: lián fēng miào
形成: xíng chéng
却步: què bù
衡志诚: héng zhì chéng
满满: mǎn mǎn
壮志未酬: zhuàng zhì wèi chóu
Ｎ股: Ｎ gǔ
水质: shuǐ zhì
305: 3 0 5
欧晋德: ōu jìn dé
民选: mín xuǎn
渊源: yuān yuán
日资: rì zī
易货: yì huò
动力: dòng lì
全天候: quán tiān hòu
Sharon: S h a r o n
泰国人: tài guó rén
出席: chū xí
悠久: yōu jiǔ
May: M a y
寒流: hán liú
鲁惠民: lǔ huì mín
修改法: xiū gǎi fǎ
碰触: pèng chù
Asian: A s i a n
挪让: nuó ràng
携带者: xié dài zhě
动工: dòng gōng
较快: jiào kuài
龙翔: lóng xiáng
挽歌: wǎn gē
鉴戒: jiàn jiè
阶级权: jiē jí quán
海外版: hǎi wài bǎn
挖潜: wā qián
穆迪: mù dí
柳州: liǔ zhōu
莅临: lì lín
39: 3 9
38: 3 8
Chinese: C h i n e s e
33: 3 3
37: 3 7
34: 3 4
贿选: huì xuǎn
心灵: xīn líng
货架: huò jià
复旦: fù dàn
HOME: H O M E
破产: pò chǎn
法老: fǎ lǎo
麦田: mài tián
讲话: jiǎng huà
讲课: jiǎng kè
理工: lǐ gōng
购物袋: gòu wù dài
苏眉: sū méi
陈碧云: chén bì yún
递送: dì sòng
稻田: dào tián
Remeliik: R e m e l i i k
５０００: ５ ０ ０ ０
四川: sì chuān
架构: jià gòu
诗文: shī wén
残疾人: cán jí rén
修船: xiū chuán
赛德克: sài dé kè
牌照: pái zhào
李君伟: lǐ jūn wěi
第二十四: dì èr shí sì
伶人: líng rén
心爱: xīn ài
胡瓜: hú guā
礼品: lǐ pǐn
汉哀帝: hàn āi dì
兰屿岛: lán yǔ dǎo
收购: shōu gòu
Toshiba: T o s h i b a
多用途: duō yòng tú
黄龙云: huáng lóng yún
贮存: zhù cún
０．１３: ０ ． １ ３
诉求: sù qiú
０．１９: ０ ． １ ９
理念: lǐ niàn
盐锅峡: yán guō xiá
两成: liǎng chéng
旅馆: lǚ guǎn
日臻: rì zhēn
田弘茂: tián hóng mào
奉天: fèng tiān
ＭＩＬ: Ｍ Ｉ Ｌ
筲箕湾: shāo jī wān
功臣: gōng chén
装饰品: zhuāng shì pǐn
铁皮: tiě pí
珠穆朗玛: zhū mù lǎng mǎ
修葺: xiū qì
成书: chéng shū
耕农: gēng nóng
幽静: yōu jìng
寒暄: hán xuān
成人: chéng rén
心理: xīn lǐ
成交: chéng jiāo
郊外: jiāo wài
师法: shī fǎ
毗邻: pí lín
汇丰: huì fēng
烦心: fán xīn
网际: wǎng jì
速效: sù xiào
双流: shuāng liú
心疼: xīn téng
义务: yì wù
後续: hòu xù
心病: xīn bìng
颜真卿: yán zhēn qīng
讲述: jiǎng shù
收讯: shōu xùn
收割: shōu gē
老师们: lǎo shī men
西芹菜: xī qín cài
器铭: qì míng
水溶性: shuǐ róng xìng
秉峄: bǐng yì
腰斩: yāo zhǎn
刘香君: liú xiāng jūn
鬓影: bìn yǐng
心皮: xīn pí
茶农们: chá nóng men
心目: xīn mù
电视法: diàn shì fǎ
４亿: ４ yì
多产: duō chǎn
瓶瓶罐罐: píng píng guàn guàn
四点五: sì diǎn wǔ
四点二: sì diǎn èr
卧室: wò shì
带动起: dài dòng qǐ
诗情: shī qíng
劫案: jié àn
Statistics: S t a t i s t i c s
侄媳: zhí xí
林林总总: lín lín zǒng zǒng
诙谐: huī xié
婚礼: hūn lǐ
审制: shěn zhì
谢东闵: xiè dōng mǐn
１８８: １ ８ ８
48: 4 8
46: 4 6
44: 4 4
45: 4 5
42: 4 2
43: 4 3
40: 4 0
41: 4 1
宽条状: kuān tiáo zhuàng
手续: shǒu xù
讲起: jiǎng qǐ
布线: bù xiàn
收视: shōu shì
理学: lǐ xué
皮海: pí hǎi
黑水: hēi shuǐ
赠送: zèng sòng
沉睡: chén shuì
联办: lián bàn
民国: mín guó
针对: zhēn duì
黑河: hēi hé
４点: ４ diǎn
自认: zì rèn
挥毫: huī háo
断面: duàn miàn
３００亿: ３ ０ ０ yì
Paoshan: P a o s h a n
复工: fù gōng
覆下: fù xià
宽裕: kuān yù
刘祥: liú xiáng
海赛克: hǎi sài kè
深具: shēn jù
元首: yuán shǒu
新陈代谢: xīn chén dài xiè
ＣＥ麦奈特: Ｃ Ｅ mài nài tè
动摇: dòng yáo
鉴定: jiàn dìng
锺士元: zhōng shì yuán
53.38: 5 3 . 3 8
选购: xuǎn gòu
植满: zhí mǎn
友邦: yǒu bāng
病逝: bìng shì
秉持: bǐng chí
较早: jiào zǎo
四时: sì shí
拜访: bài fǎng
首饰: shǒu shì
Know-how: K n o w - h o w
四日: sì rì
武黄: wǔ huáng
新西兰队: xīn xī lán duì
ＣＡＣ: Ｃ Ａ Ｃ
显径: xiǎn jìng
近千馀: jìn qiān yú
营业用: yíng yè yòng
使用者: shǐ yòng zhě
铬铁: gè tiě
字牌: zì pái
Nielsen: N i e l s e n
CNES: C N E S
职衔: zhí xián
首页: shǒu yè
酷哥: kù gē
烦恼: fán nǎo
黑潮: hēi cháo
雌威: cí wēi
浮现: fú xiàn
酷吏: kù lì
双双: shuāng shuāng
挂心: guà xīn
诈骗: zhà piàn
甜美: tián měi
寒天: hán tiān
寒夜: hán yè
Ｍｒ: Ｍ ｒ
脸蛋: liǎn dàn
城厢: chéng xiāng
馀裕: yú yù
交纳: jiāo nà
理想: lǐ xiǎng
成癖: chéng pǐ
病院: bìng yuàn
ＭＷ: Ｍ Ｗ
洪灾: hóng zāi
返国: fǎn guó
返回: fǎn huí
板门店: bǎn mén diàn
理性: lǐ xìng
米兰: mǐ lán
成真: chéng zhēn
伪证: wěi zhèng
总计: zǒng jì
西唐刚: xī táng gāng
早逝: zǎo shì
短短: duǎn duǎn
争夺战: zhēng duó zhàn
预选赛: yù xuǎn sài
挽回: wǎn huí
四成: sì chéng
鳄鱼湖: è yú hú
止息: zhǐ xī
浮生: fú shēng
动怒: dòng nù
标枪: biāo qiāng
挖到: wā dào
望乡: wàng xiāng
动态: dòng tài
航班: háng bān
殉职: xùn zhí
层层叠叠: céng céng dié dié
职业赛: zhí yè sài
自负: zì fù
总裁: zǒng cái
伪装: wěi zhuāng
挖出: wā chū
源自: yuán zì
老师: lǎo shī
显学: xiǎn xué
心仪: xīn yí
满布: mǎn bù
55: 5 5
搅乱: jiǎo luàn
53: 5 3
腰带: yāo dài
显宗: xiǎn zōng
罚锾: fá huán
来源国: lái yuán guó
慷慨: kāng kǎi
秦代: qín dài
建设: jiàn shè
悠缓: yōu huǎn
恬静: tián jìng
公民营: gōng mín yíng
简牍: jiǎn dú
自豪: zì háo
破烂: pò làn
丝绸染: sī chóu rǎn
炙热: zhì rè
瑞士: ruì shì
满心: mǎn xīn
第４８: dì ４ ８
动手: dòng shǒu
联谊: lián yì
情谊: qíng yì
国企所: guó qǐ suǒ
破灭: pò miè
两全: liǎng quán
马球: mǎ qiú
默默: mò mò
健力: jiàn lì
珊瑚: shān hú
候补: hòu bǔ
短程: duǎn chéng
三Ｋ党: sān Ｋ dǎng
整修: zhěng xiū
选萃: xuǎn cuì
裁判: cái pàn
颂念: sòng niàn
李佩: lǐ pèi
严冬: yán dōng
刘卫国: liú wèi guó
城建: chéng jiàn
马跃: mǎ yuè
紧箍咒: jǐn gū zhòu
裙礁: qún jiāo
贵阳: guì yáng
四溢: sì yì
雕版: diāo bǎn
李伟: lǐ wěi
霞塘: xiá táng
常用: cháng yòng
自花: zì huā
布鲁诺: bù lǔ nuò
外文: wài wén
ＡＴ＆Ｔ: Ａ Ｔ ＆ Ｔ
杀进: shā jìn
两千: liǎng qiān
娘娘: niáng niáng
逼近: bī jìn
货品: huò pǐn
遥遥: yáo yáo
四周: sì zhōu
证实: zhèng shí
十三亿: shí sān yì
黑暗: hēi àn
渊博: yuān bó
张云飞: zhāng yún fēi
远及: yuǎn jí
议题: yì tí
代替: dài tì
苏联队: sū lián duì
首选: shǒu xuǎn
黑板: hēi bǎn
寒冬: hán dōng
武韬: wǔ tāo
森林队: sēn lín duì
李善远: lǐ shàn yuǎn
驻防: zhù fáng
满口: mǎn kǒu
健全: jiàn quán
甲肝: jiǎ gān
梨山: lí shān
盘锦: pán jǐn
习题: xí tí
县级: xiàn jí
陈韵雁: chén yùn yàn
株连: zhū lián
双层: shuāng céng
彻悟: chè wù
加德士: jiā dé shì
人保: rén bǎo
影坛: yǐng tán
随心所欲: suí xīn suǒ yù
驱动力: qū dòng lì
电脑业: diàn nǎo yè
复健: fù jiàn
辽西: liáo xī
Hinoki: H i n o k i
乡镇: xiāng zhèn
萨维尔: sà wéi ěr
显出: xiǎn chū
Dollar: D o l l a r
连日来: lián rì lái
60: 6 0
62: 6 2
63: 6 3
64: 6 4
65: 6 5
67: 6 7
69: 6 9
後人: hòu rén
复出: fù chū
後代: hòu dài
复决: fù jué
杨照: yáng zhào
闭门: bì mén
2.49: 2 . 4 9
姜蜜: jiāng mì
ＭＡＩ: Ｍ Ａ Ｉ
後世: hòu shì
邻邦: lín bāng
邵友保: shào yǒu bǎo
资讯界: zī xùn jiè
入袋: rù dài
显像: xiǎn xiàng
津贴: jīn tiē
急急忙忙: jí jí máng máng
鲍萨: bào sà
翻新: fān xīn
货值: huò zhí
爱国者: ài guó zhě
动武: dòng wǔ
巴望: bā wàng
氧生: yǎng shēng
复利: fù lì
复制: fù zhì
哀悼: āi dào
二点五: èr diǎn wǔ
学者们: xué zhě men
滚进: gǔn jìn
音程: yīn chéng
架势: jià shì
手书: shǒu shū
黄世耀: huáng shì yào
Ｇenetics: Ｇ e n e t i c s
戴国辉: dài guó huī
复原: fù yuán
杨玛利: yáng mǎ lì
Space: S p a c e
返工: fǎn gōng
１２４１．８１: １ ２ ４ １ ． ８ １
二点三: èr diǎn sān
交界: jiāo jiè
使用费: shǐ yòng fèi
杨文生: yáng wén shēng
保护器: bǎo hù qì
航程: háng chéng
融入: róng rù
心境: xīn jìng
糟糕: zāo gāo
计时: jì shí
货人: huò rén
disk: d i s k
浮想: fú xiǎng
菠菜: bō cài
敲定: qiāo dìng
音效: yīn xiào
货代: huò dài
州际: zhōu jì
浴缸: yù gāng
直线绣: zhí xiàn xiù
敬礼: jìng lǐ
止痛: zhǐ tòng
十二点四亿: shí èr diǎn sì yì
盘踞: pán jù
坝址: bà zhǐ
what: w h a t
动画: dòng huà
动用: dòng yòng
织锦缎: zhī jǐn duàn
整型: zhěng xíng
孟晖: mèng huī
汉风: hàn fēng
糙米: cāo mǐ
宽频: kuān pín
马洪: mǎ hóng
影剧: yǐng jù
目录学: mù lù xué
诗人: shī rén
伊朗: yī lǎng
邵炜刚: shào wěi gāng
先生们: xiān shēng men
张海涛: zhāng hǎi tāo
奉献: fèng xiàn
志愿军: zhì yuàn jūn
破晓: pò xiǎo
２１８０．３０: ２ １ ８ ０ ． ３ ０
坪林人: píng lín rén
56.33: 5 6 . 3 3
1.95: 1 . 9 5
热爱: rè ài
交棒: jiāo bàng
偏向: piān xiàng
锅炉: guō lú
靠山: kào shān
回归颂: huí guī sòng
３０多: ３ ０ duō
贵贱: guì jiàn
麦帅: mài shuài
破旧: pò jiù
邻近: lín jìn
学养: xué yǎng
坪林乡: píng lín xiāng
定装照: dìng zhuāng zhào
刘歆: liú xīn
觊觎: jì yú
//: / /
贵宾室: guì bīn shì
ＡＣ米兰队: Ａ Ｃ mǐ lán duì
１２６．４: １ ２ ６ ． ４
１２６．１: １ ２ ６ ． １
衢州: qú zhōu
编译馆: biān yì guǎn
手动: shǒu dòng
77: 7 7
73: 7 3
72: 7 2
71: 7 1
70: 7 0
影像: yǐng xiàng
辽阔: liáo kuò
西花菜: xī huā cài
菜农们: cài nóng men
布莱尔: bù lái ěr
短暂: duǎn zàn
裙摆: qún bǎi
类型: lèi xíng
礼堂: lǐ táng
秦山: qín shān
起诉者: qǐ sù zhě
紧邻: jǐn lín
资源: zī yuán
武装: wǔ zhuāng
宣导: xuān dǎo
２１６３２亿: ２ １ ６ ３ ２ yì
热木纳村: rè mù nà cūn
破损: pò sǔn
敲开: qiāo kāi
影城: yǐng chéng
饿死: è sǐ
桥基: qiáo jī
健保: jiàn bǎo
刘海: liú hǎi
成材: chéng cái
19.8: 1 9 . 8
逼退: bī tuì
外国人: wài guó rén
４日: ４ rì
志愿者们: zhì yuàn zhě men
代码: dài mǎ
欲望: yù wàng
笔画: bǐ huà
两亿: liǎng yì
後嗣: hòu sì
偏偏: piān piān
１７１４: １ ７ １ ４
计画案: jì huà àn
补偿费: bǔ cháng fèi
资江: zī jiāng
交汇: jiāo huì
毕生: bì shēng
偏僻: piān pì
学到: xué dào
短文: duǎn wén
二水人: èr shuǐ rén
３００多: ３ ０ ０ duō
学制: xué zhì
鹊起: què qǐ
资深: zī shēn
心志: xīn zhì
鼓舞: gǔ wǔ
四点: sì diǎn
渤海湾: bó hǎi wān
成效: chéng xiào
心念: xīn niàn
两仪: liǎng yí
动物: dòng wù
麦寮: mài liáo
交流: jiāo liú
慈善赛: cí shàn sài
武警: wǔ jǐng
瓷器: cí qì
影响: yǐng xiǎng
浮木: fú mù
蒽醌法: ēn kūn fǎ
97-05-13: 9 7 - 0 5 - 1 3
营业性: yíng yè xìng
元老: yuán lǎo
後宫: hòu gōng
早起: zǎo qǐ
垄断: lǒng duàn
汉口: hàn kǒu
３４０亿: ３ ４ ０ yì
延续性: yán xù xìng
表彰: biǎo zhāng
顾问网: gù wèn wǎng
航海: háng hǎi
凭吊: píng diào
２３亿: ２ ３ yì
山西: shān xī
偏废: piān fèi
关键性: guān jiàn xìng
洪水: hóng shuǐ
耕田: gēng tián
总队: zǒng duì
交战: jiāo zhàn
久候多时: jiǔ hòu duō shí
李玉祥: lǐ yù xiáng
046: 0 4 6
布基纳法索: bù jī nà fǎ suǒ
042: 0 4 2
生态学界: shēng tài xué jiè
洪涝: hóng lào
陈忠勇: chén zhōng yǒng
翻版: fān bǎn
羁旅: jī lǚ
城乡: chéng xiāng
交换: jiāo huàn
整建: zhěng jiàn
李必: lǐ bì
蒋贡: jiǎng gòng
口水战: kǒu shuǐ zhàn
僵局: jiāng jú
代理: dài lǐ
诊断仪: zhěn duàn yí
生理学: shēng lǐ xué
柳缙: liǔ jìn
Ｈ２－２: Ｈ ２ － ２
心力: xīn lì
130: 1 3 0
心动: xīn dòng
尝到: cháng dào
交情: jiāo qíng
敲击: qiāo jī
临近: lín jìn
首脑: shǒu nǎo
88: 8 8
甲醇: jiǎ chún
80: 8 0
87: 8 7
常昊: cháng hào
钱彤: qián tóng
渡口: dù kǒu
8d: 8 d
另外: lìng wài
仪仗队: yí zhàng duì
谘商: zī shāng
外乡人: wài xiāng rén
尖叫: jiān jiào
自选: zì xuǎn
对岸: duì àn
床垫: chuáng diàn
BLUE: B L U E
后加工: hòu jiā gōng
悠扬: yōu yáng
哀痛: āi tòng
面对面: miàn duì miàn
杨柳: yáng liǔ
沉沉: chén chén
钱布: qián bù
沉沦: chén lún
４０４亿: ４ ０ ４ yì
交替: jiāo tì
洪森: hóng sēn
浮法: fú fǎ
返乡: fǎn xiāng
１９７: １ ９ ７
文集: wén jí
莲雾: lián wù
KITTY: K I T T Y
凭借: píng jiè
常态: cháng tài
１１９．９亿: １ １ ９ ． ９ yì
手工: shǒu gōng
此时: cǐ shí
钱复: qián fù
交易: jiāo yì
日人: rì rén
音标: yīn biāo
默认: mò rèn
影带: yǐng dài
MBA: M B A
飞鼠: fēi shǔ
装饰物: zhuāng shì wù
脑力: nǎo lì
捡起: jiǎn qǐ
选配: xuǎn pèi
学者层: xué zhě céng
雕塑类: diāo sù lèi
慰安妇: wèi ān fù
李安: lǐ ān
鸭鸭牌: yā yā pái
鱼贝类: yú bèi lèi
踪迹: zōng jī
常规赛: cháng guī sài
ＮＢＡ: Ｎ Ｂ Ａ
电脑展: diàn nǎo zhǎn
法律案: fǎ lǜ àn
表妹: biǎo mèi
植物: zhí wù
质变: zhì biàn
友谊: yǒu yì
○．三: ○ ． sān
武艺: wǔ yì
秦国: qín guó
自问: zì wèn
Wushe: W u s h e
集资额: jí zī é
编码法: biān mǎ fǎ
公社债: gōng shè zhài
棉纺锭: mián fǎng dìng
证严: zhèng yán
影展: yǐng zhǎn
ＹＹ: Ｙ Ｙ
闯闯: chuǎng chuǎng
８００多: ８ ０ ０ duō
动窝: dòng wō
浮潜: fú qián
证人: zhèng rén
水晶矿: shuǐ jīng kuàng
棉纺: mián fǎng
後山: hòu shān
交收: jiāo shōu
劳务: láo wù
宽阔: kuān kuò
馈赠: kuì zèng
赣江: gàn jiāng
集邮局: jí yóu jú
黑豹: hēi bào
总算: zǒng suàn
定值: dìng zhí
修士: xiū shì
苏永钦: sū yǒng qīn
烈士: liè shì
官吏: guān lì
选民: xuǎn mín
做做: zuò zuò
翻译: fān yì
银丝: yín sī
收回: shōu huí
Basic: B a s i c
沉陷: chén xiàn
修改: xiū gǎi
修复: xiū fù
危险群: wēi xiǎn qún
审计法: shěn jì fǎ
91: 9 1
90: 9 0
93: 9 3
95: 9 5
94: 9 4
97: 9 7
96: 9 6
订户: dìng hù
益加: yì jiā
爱情: ài qíng
操劳: cāo láo
代谢: dài xiè
彩电: cǎi diàn
洪锦: hóng jǐn
做兵: zuò bīng
安养院: ān yǎng yuàn
柯尔: kē ěr
宋徽宗: sòng huī zōng
萧芳芳: xiāo fāng fāng
判罚: pàn fá
驻美: zhù měi
0.83: 0 . 8 3
操兵: cāo bīng
法学: fǎ xué
生嫩: shēng nèn
张维财: zhāng wéi cái
法宝: fǎ bǎo
法官: fǎ guān
法定: fǎ dìng
炼狱: liàn yù
宋楚瑜: sòng chǔ yú
突击: tū jī
突出: tū chū
做到: zuò dào
借自: jiè zì
歌舞剧: gē wǔ jù
音阶: yīn jiē
修学: xiū xué
玛瑙珠: mǎ nǎo zhū
死心: sǐ xīn
日夜: rì yè
16.81: 1 6 . 8 1
乡民: xiāng mín
箝制: qián zhì
剩下: shèng xià
层出: céng chū
水塘: shuǐ táng
生存: shēng cún
生字: shēng zì
右拳: yòu quán
初具雏形: chū jù chú xíng
爱护: ài hù
收到: shōu dào
林瑞图: lín ruì tú
日常: rì cháng
易帜: yì zhì
雪梨: xuě lí
微生物: wēi shēng wù
义工队: yì gōng duì
博物馆界: bó wù guǎn jiè
水库: shuǐ kù
汉成帝: hàn chéng dì
深耕: shēn gēng
元素: yuán sù
104: 1 0 4
误杀: wù shā
代表: dài biǎo
丛生: cóng shēng
日志: rì zhì
策画: cè huà
使用权: shǐ yòng quán
早点: zǎo diǎn
２５: ２ ５
２６: ２ ６
张静茹: zhāng jìng rú
自满: zì mǎn
日後: rì hòu
策略: cè lüè
２３: ２ ３
２８: ２ ８
浮雕: fú diāo
新新旧旧: xīn xīn jiù jiù
自流: zì liú
收储: shōu chǔ
严树芬: yán shù fēn
动荡: dòng dàng
豆腐渣: dòu fǔ zhā
修建: xiū jiàn
法律: fǎ lǜ
软软甜甜: ruǎn ruǎn tián tián
佐冢爱佑: zuǒ zhǒng ài yòu
常驻: cháng zhù
碰壁: pèng bì
爱尔兰: ài ěr lán
断然: duàn rán
递交: dì jiāo
法师: fǎ shī
彩玻: cǎi bō
收入: shōu rù
收养: shōu yǎng
HELLO: H E L L O
斩断: zhǎn duàn
纲目: gāng mù
qin: q i n
杀手: shā shǒu
法庭: fǎ tíng
法规性: fǎ guī xìng
陈农: chén nóng
戈杰安: gē jié ān
锁码: suǒ mǎ
左右: zuǒ yòu
定型: dìng xíng
狭义: xiá yì
病痛: bìng tòng
杀戮: shā lù
日剧: rì jù
民代: mín dài
步出: bù chū
捣乱: dǎo luàn
功利: gōng lì
黄荣峰: huáng róng fēng
功力: gōng lì
左岸: zuǒ àn
动起: dòng qǐ
步兵: bù bīng
黑珍珠: hēi zhēn zhū
法军: fǎ jūn
功劳: gōng láo
收店: shōu diàn
刘邦: liú bāng
水力: shuǐ lì
疮疤: chuāng bā
翻船: fān chuán
源源: yuán yuán
民俗: mín sú
自我: zì wǒ
辽河: liáo hé
怪状: guài zhuàng
凤凰: fèng huáng
二十点五亿: èr shí diǎn wǔ yì
PMIC: P M I C
沉默: chén mò
议程: yì chéng
谢希德: xiè xī dé
宽恕: kuān shù
伤病: shāng bìng
理财: lǐ cái
伤痛: shāng tòng
水利: shuǐ lì
易县: yì xiàn
诀窍: jué qiào
生养: shēng yǎng
９·８１２: ９ · ８ １ ２
讲学: jiǎng xué
自愿: zì yuàn
水军: shuǐ jūn
李茂宗: lǐ mào zōng
鲍恩: bào ēn
收尸: shōu shī
卧轨: wò guǐ
生动: shēng dòng
彩练: cǎi liàn
蕨类: jué lèi
队旗: duì qí
水准: shuǐ zhǔn
二千多: èr qiān duō
修到: xiū dào
动辄: dòng zhé
侦测器: zhēn cè qì
７８．８９亿: ７ ８ ． ８ ９ yì
四起: sì qǐ
显像管: xiǎn xiàng guǎn
汉代人: hàn dài rén
官帽: guān mào
音响: yīn xiǎng
法制: fǎ zhì
定存: dìng cún
罗新社: luó xīn shè
法则: fǎ zé
日元: rì yuán
拜拜: bài bài
职业性: zhí yè xìng
纺品: fǎng pǐn
舀起: yǎo qǐ
源泉: yuán quán
日减: rì jiǎn
眷村: juàn cūn
健美: jiàn měi
拜托: bài tuō
定定: dìng dìng
侦办: zhēn bàn
日军: rì jūn
定局: dìng jú
悠闲: yōu xián
旅业: lǚ yè
选情: xuǎn qíng
汉文: hàn wén
碰到: pèng dào
交集: jiāo jí
变脸: biàn liǎn
较诸: jiào zhū
彩磁: cǎi cí
水域: shuǐ yù
谭凤珠: tán fèng zhū
自来: zì lái
工业性: gōng yè xìng
逼真: bī zhēn
法商: fǎ shāng
因势就导: yīn shì jiù dǎo
矿产品: kuàng chǎn pǐn
纠缠: jiū chán
眷恋: juàn liàn
益形: yì xíng
水坝: shuǐ bà
３１日: ３ １ rì
生命: shēng mìng
总成: zǒng chéng
烫伤: tàng shāng
代马: dài mǎ
队报: duì bào
爱民: ài mín
右江: yòu jiāng
荣誉: róng yù
做工: zuò gōng
闺阁: guī gé
２７２５０亿: ２ ７ ２ ５ ０ yì
志愿们: zhì yuàn men
今晚: jīn wǎn
痛楚: tòng chǔ
DIY: D I Y
昨日: zuó rì
成龙: chéng lóng
砂砾: shā lì
津滨: jīn bīn
翩然: piān rán
举办: jǔ bàn
如痴如醉: rú chī rú zuì
紧凑: jǐn còu
层层: céng céng
昨晚: zuó wǎn
组织网: zǔ zhī wǎng
１１０: １ １ ０
动词: dòng cí
今日: jīn rì
日后: rì hòu
牧民: mù mín
整改: zhěng gǎi
宽松: kuān sōng
选手: xuǎn shǒu
层峦: céng luán
林业: lín yè
层峰: céng fēng
杀死: shā sǐ
选战: xuǎn zhàn
颁授: bān shòu
李元佳: lǐ yuán jiā
抖动: dǒu dòng
日商: rì shāng
收复: shōu fù
译者: yì zhě
营业额: yíng yè é
领悟: lǐng wù
毫米: háo mǐ
１１５．９０: １ １ ５ ． ９ ０
1111: 1 1 1 1
奉贤: fèng xián
法国: fǎ guó
独到: dú dào
定律: dìng lǜ
交锋: jiāo fēng
交错: jiāo cuò
总统: zǒng tǒng
自筹: zì chóu
１７日: １ ７ rì
联交所: lián jiāo suǒ
临时: lín shí
初出茅庐: chū chū máo lú
２４９: ２ ４ ９
述评: shù píng
刘必荣: liú bì róng
早早: zǎo zǎo
早日: zǎo rì
黑鲔: hēi wěi
小民: xiǎo mín
独唱: dú chàng
武汉: wǔ hàn
替代者: tì dài zhě
彩旗: cǎi qí
惨境: cǎn jìng
资讯: zī xùn
驻法: zhù fǎ
ＦＯＲＴＲＡＮ: Ｆ Ｏ Ｒ Ｔ Ｒ Ａ Ｎ
总署: zǒng shǔ
汉砖: hàn zhuān
文天祥: wén tiān xiáng
再就业: zài jiù yè
碳酸锂: tàn suān lǐ
借债: jiè zhài
西松: xī sōng
人心惶恐: rén xīn huáng kǒng
丢到: diū dào
浑天仪: hún tiān yí
国宝级: guó bǎo jí
诈欺: zhà qī
借口: jiè kǒu
陈晓东: chén xiǎo dōng
严加: yán jiā
奉送: fèng sòng
器官: qì guān
病患: bìng huàn
悻悻: xìng xìng
病情: bìng qíng
惨剧: cǎn jù
黑黑: hēi hēi
自私: zì sī
习性: xí xìng
早晨: zǎo chén
男性美: nán xìng měi
肇庆: zhào qìng
东西向: dōng xī xiàng
贪多: tān duō
B&Q: B & Q
伊藤: yī téng
恋人们: liàn rén men
严厉: yán lì
微循环: wēi xún huán
习惯: xí guàn
钟点费: zhōng diǎn fèi
翻飞: fān fēi
败在: bài zài
日久: rì jiǔ
破获: pò huò
自编: zì biān
自置: zì zhì
１４５: １ ４ ５
殉葬: xùn zàng
踊跃: yǒng yuè
民力: mín lì
证物: zhèng wù
芝山岩: zhī shān yán
独具: dú jù
cstudio: c s t u d i o
棉纺织: mián fǎng zhī
民初: mín chū
陈履安: chén lǚ ān
独领风骚: dú lǐng fēng sāo
状况: zhuàng kuàng
马惠珍: mǎ huì zhēn
水产: shuǐ chǎn
邻桌: lín zhuō
常规: cháng guī
水东: shuǐ dōng
狭小: xiá xiǎo
败因: bài yīn
瓮墙: wèng qiáng
床组: chuáng zǔ
状元: zhuàng yuán
历纸: lì zhǐ
成军: chéng jūn
水乡: shuǐ xiāng
２２日: ２ ２ rì
让炯日佩多杰: ràng jiǒng rì pèi duō jié
炒到: chǎo dào
修习: xiū xí
生产: shēng chǎn
悠远: yōu yuǎn
文诌诌: wén zhōu zhōu
黑马: hēi mǎ
风云: fēng yún
逃到: táo dào
生下: shēng xià
维护者: wéi hù zhě
盘根: pán gēn
Domain: D o m a i n
厨师: chú shī
８５０６亿: ８ ５ ０ ６ yì
鼓掌: gǔ zhǎng
步伐: bù fá
废墟: fèi xū
丛林: cóng lín
五成三: wǔ chéng sān
常设: cháng shè
民心: mín xīn
吉·戈杰安: jí · gē jié ān
独力: dú lì
民兵: mín bīng
法人: fǎ rén
西欧: xī ōu
遥测: yáo cè
交货: jiāo huò
总社: zǒng shè
想必: xiǎng bì
伤残: shāng cán
资质: zī zhì
资财: zī cái
领骑衫: lǐng qí shān
盐寮湾: yán liáo wān
李瑞环: lǐ ruì huán
利基点: lì jī diǎn
驻日: zhù rì
二十二点三三亿: èr shí èr diǎn sān sān yì
马萨: mǎ sà
递减: dì jiǎn
赤裸裸: chì luǒ luǒ
二十五亿: èr shí wǔ yì
裙装: qún zhuāng
判断: pàn duàn
想像: xiǎng xiàng
损益表: sǔn yì biǎo
紫外线: zǐ wài xiàn
犯罪: fàn zuì
法学院: fǎ xué yuàn
黑锅: hēi guō
短评: duǎn píng
欧吉桑: ōu jí sāng
网友: wǎng yǒu
哥哥: gē gē
雕花: diāo huā
总督: zǒng dū
怪手: guài shǒu
镇公所: zhèn gōng suǒ
选用: xuǎn yòng
林玲君: lín líng jūn
自然: zì rán
龛堂: kān táng
遥想: yáo xiǎng
铸钱: zhù qián
左下: zuǒ xià
短裤: duǎn kù
坡璃: pō lí
日久生厌: rì jiǔ shēng yàn
音轨: yīn guǐ
三十五亿: sān shí wǔ yì
破败: pò bài
张杏如: zhāng xìng rú
邬焕庆: wū huàn qìng
澧水: lǐ shuǐ
两亿多: liǎng yì duō
Ｖ形: Ｖ xíng
短视: duǎn shì
甜蜜: tián mì
复赛权: fù sài quán
Ｍ0: Ｍ 0
Ｍ2: Ｍ 2
刘菁: liú jīng
严审: yán shěn
哥国: gē guó
议案: yì àn
鸣啭: míng zhuàn
严密: yán mì
表现欲: biǎo xiàn yù
严寒: yán hán
文艺奖: wén yì jiǎng
殴骂: ōu mà
孙黛云: sūn dài yún
全国: quán guó
严峻: yán jùn
裘兆琳: qiú zhào lín
丢开: diū kāi
丢弃: diū qì
理顺: lǐ shùn
想到: xiǎng dào
8.1: 8 . 1
8.2: 8 . 2
翻阅: fān yuè
伤愈: shāng yù
权威性: quán wēi xìng
二点五亿: èr diǎn wǔ yì
申亚乡: shēn yà xiāng
愚蠢: yú chǔn
侨选: qiáo xuǎn
二千亿: èr qiān yì
厚街镇: hòu jiē zhèn
儒学: rú xué
麦肯锡: mài kěn xī
mosaic: m o s a i c
远征军: yuǎn zhēng jūn
网坛: wǎng tán
元旦: yuán dàn
网址: wǎng zhǐ
定义: dìng yì
力克: lì kè
电影业: diàn yǐng yè
疲劳: pí láo
厌憎: yàn zēng
浮躁: fú zào
热热闹闹: rè rè nào nào
饭碗: fàn wǎn
乡村: xiāng cūn
音讯: yīn xùn
字迹: zì jī
今生: jīn shēng
爱美: ài měi
马芬: mǎ fēn
淮河: huái hé
成败: chéng bài
元朗: yuán lǎng
检验所: jiǎn yàn suǒ
史书: shǐ shū
淮海: huái hǎi
润泰: rùn tài
唐庆忠: táng qìng zhōng
克尔特: kè ěr tè
四顾: sì gù
９·７１２: ９ · ７ １ ２
厌恨: yàn hèn
文人们: wén rén men
使领馆: shǐ lǐng guǎn
雪珂: xuě kē
殃及: yāng jí
武岚: wǔ lán
制药业: zhì yào yè
毫升: háo shēng
宰杀: zǎi shā
日程: rì chéng
破财: pò cái
独断: dú duàn
手腕: shǒu wàn
覆辙: fù zhé
队伍: duì wǔ
钦定: qīn dìng
威胁性: wēi xié xìng
痴心: chī xīn
厌弃: yàn qì
布匹: bù pǐ
全哲洙: quán zhé zhū
严惩: yán chéng
收益: shōu yì
层状: céng zhuàng
定点: dìng diǎn
收盘: shōu pán
伊豆: yī dòu
儒林: rú lín
侦破: zhēn pò
宫城: gōng chéng
独撑: dú chēng
病危: bìng wēi
做错: zuò cuò
器械: qì xiè
8.37: 8 . 3 7
病原: bìng yuán
罚则: fá zé
总理: zǒng lǐ
苏轼: sū shì
靠近: kào jìn
胡辛: hú xīn
城门: chéng mén
驻德: zhù dé
彩图: cǎi tú
乳制品: rǔ zhì pǐn
男性们: nán xìng men
维生素: wéi shēng sù
十点钟: shí diǎn zhōng
议决: yì jué
闹热滚滚: nào rè gǔn gǔn
ＡＢＣ: Ａ Ｂ Ｃ
ＡＢＳ: Ａ Ｂ Ｓ
突然: tū rán
贵州: guì zhōu
雪人: xuě rén
筹资: chóu zī
疫苗: yì miáo
武帝: wǔ dì
城镇: chéng zhèn
饶恕: ráo shù
选书: xuǎn shū
荣毅仁: róng yì rén
泾县: jīng xiàn
诚品: chéng pǐn
选举: xuǎn jǔ
赠勋: zèng xūn
National: N a t i o n a l
陌生: mò shēng
鼓噪: gǔ zào
二成三: èr chéng sān
画像砖: huà xiàng zhuān
选修: xuǎn xiū
谈恋爱: tán liàn ài
二成二: èr chéng èr
元宝: yuán bǎo
五点四: wǔ diǎn sì
後者: hòu zhě
元宵: yuán xiāo
尝试: cháng shì
启航: qǐ háng
早先: zǎo xiān
自负额: zì fù é
定理: dìng lǐ
兵役: bīng yì
武士: wǔ shì
状态: zhuàng tài
驻外: zhù wài
水缸: shuǐ gāng
Ｍ1: Ｍ 1
覆议: fù yì
米酒: mǐ jiǔ
水网: shuǐ wǎng
自修: zì xiū
议坛: yì tán
李芳: lǐ fāng
诺基亚: nuò jī yà
自保: zì bǎo
贵宾: guì bīn
刘玉兰: liú yù lán
功绩: gōng jī
历久弥新: lì jiǔ mí xīn
电影界: diàn yǐng jiè
抑制: yì zhì
汐止: xī zhǐ
今人: jīn rén
首席: shǒu xí
武士债: wǔ shì zhài
纠风办: jiū fēng bàn
蒋公: jiǎng gōng
展览厅: zhǎn lǎn tīng
谘询: zī xún
仁宝: rén bǎo
届时: jiè shí
潜修: qián xiū
矿山: kuàng shān
西域: xī yù
定心丸: dìng xīn wán
臃肿: yōng zhǒng
法文版: fǎ wén bǎn
卢秀琴: lú xiù qín
质询: zhì xún
姑娘们: gū niáng men
瓷板画: cí bǎn huà
贵妇: guì fù
Prince: P r i n c e
两千亿: liǎng qiān yì
判定: pàn dìng
借来: jiè lái
赎罪: shú zuì
汉人: hàn rén
Men's: M e n ' s
修缮: xiū shàn
汉代: hàn dài
楹联: yíng lián
返销: fǎn xiāo
默克: mò kè
鼓励: gǔ lì
装饰性: zhuāng shì xìng
整肃: zhěng sù
旅日: lǚ rì
李鸿源: lǐ hóng yuán
议定: yì dìng
心肝: xīn gān
怪叫: guài jiào
阎肃: yán sù
心胸: xīn xiōng
恐惧: kǒng jù
驻唱: zhù chàng
讲稿: jiǎng gǎo
Charming: C h a r m i n g
表述: biǎo shù
ｗｗｗ·ｃｏｕｎｓｅｌ·ｃｏｍ·ｃｎ: ｗ ｗ ｗ · ｃ ｏ ｕ ｎ ｓ ｅ ｌ · ｃ ｏ ｍ · ｃ ｎ
想想: xiǎng xiǎng
生灵: shēng líng
惨案: cǎn àn
钱财: qián cái
犯人: fàn rén
彩棒: cǎi bàng
２９日: ２ ９ rì
克朗: kè lǎng
手表: shǒu biǎo
验收: yàn shōu
学理: xué lǐ
烈焰: liè yàn
全国性: quán guó xìng
成品: chéng pǐn
天然林: tiān rán lín
负责人: fù zé rén
保健权: bǎo jiàn quán
首先: shǒu xiān
娘姨们: niáng yí men
乡史: xiāng shǐ
民法: mín fǎ
危险品: wēi xiǎn pǐn
护卫舰: hù wèi jiàn
天成: tiān chéng
定稿: dìng gǎo
怪兽: guài shòu
民航局: mín háng jú
手记: shǒu jì
逼使: bī shǐ
四季豆: sì jì dòu
影视: yǐng shì
武器: wǔ qì
彩带: cǎi dài
生物: shēng wù
日照: rì zhào
临床: lín chuáng
COOLMAX: C O O L M A X
孙辈: sūn bèi
表象: biǎo xiàng
Source: S o u r c e
後裔: hòu yì
突破: tū pò
杀人: shā rén
生猛: shēng měng
断层: duàn céng
邻国: lín guó
生猪: shēng zhū
赖秀如: lài xiù rú
左翼: zuǒ yì
水灾: shuǐ zāi
辽东: liáo dōng
幽情: yōu qíng
十二点三四亿: shí èr diǎn sān sì yì
９３７４．２７: ９ ３ ７ ４ ． ２ ７
新新闻: xīn xīn wén
驻军: zhù jūn
後辈: hòu bèi
修理: xiū lǐ
瞩目: zhǔ mù
东西欧: dōng xī ōu
法界: fǎ jiè
麦考: mài kǎo
奢望: shē wàng
疲惫: pí bèi
疲态: pí tài
收窄: shōu zhǎi
日益: rì yì
判准: pàn zhǔn
尔後: ěr hòu
厮杀: sī shā
国界: guó jiè
判决: pàn jué
层级: céng jí
米饭: mǐ fàn
警务厅: jǐng wù tīng
网架: wǎng jià
公署: gōng shǔ
２．５亿: ２ ． ５ yì
生病: shēng bìng
展览室: zhǎn lǎn shì
民歌: mín gē
雏形: chú xíng
因特网股: yīn tè wǎng gǔ
９日: ９ rì
水疗: shuǐ liáo
腰际: yāo jì
武力: wǔ lì
审议案: shěn yì àn
武功: wǔ gōng
手软: shǒu ruǎn
器材: qì cái
udnjob: u d n j o b
篆字: zhuàn zì
独步: dú bù
贵出: guì chū
水电: shuǐ diàn
届满: jiè mǎn
EMBA: E M B A
麦芽: mài yá
旅法: lǚ fǎ
轻工业: qīng gōng yè
苏联: sū lián
想望: xiǎng wàng
秀姑峦: xiù gū luán
寒门: hán mén
定罪: dìng zuì
爱乡: ài xiāng
三三○: sān sān ○
日用: rì yòng
想来: xiǎng lái
判刑: pàn xíng
厌倦: yàn juàn
伤口: shāng kǒu
整装: zhěng zhuāng
水球: shuǐ qiú
贸易: mào yì
爱人: ài rén
谈判桌: tán pàn zhuō
双龙: shuāng lóng
凤梨: fèng lí
修桥: xiū qiáo
痛哭: tòng kū
二成: èr chéng
雪山: xuě shān
表面: biǎo miàn
自学: zì xué
自营: zì yíng
惨烈: cǎn liè
工农业: gōng nóng yè
生根: shēng gēn
自导: zì dǎo
海鸥牌: hǎi ōu pái
队形: duì xíng
狭碍: xiá ài
讲授: jiǎng shòu
右倾: yòu qīng
健诊: jiàn zhěn
心悸: xīn jì
爱国心: ài guó xīn
昨天: zuó tiān
逃生: táo shēng
法案: fǎ àn
二手: èr shǒu
赣州: gàn zhōu
复赛: fù sài
心情: xīn qíng
Sensing: S e n s i n g
绸缎: chóu duàn
二三十: èr sān shí
杨新河: yáng xīn hé
自备: zì bèi
稻黍: dào shǔ
形状: xíng zhuàng
驻俄: zhù é
步步: bù bù
永嘉人: yǒng jiā rén
馀生者: yú shēng zhě
做成: zuò chéng
总局: zǒng jú
自如: zì rú
刘继伍: liú jì wǔ
三点三亿: sān diǎn sān yì
三十点三二亿: sān shí diǎn sān èr yì
存在: cún zài
汉字: hàn zì
杨仁寿: yáng rén shòu
二十四亿: èr shí sì yì
今天: jīn tiān
汉学: hàn xué
狭窄: xiá zhǎi
竭力: jié lì
驻京: zhù jīng
仁川: rén chuān
学龄: xué líng
颁布: bān bù
惯常: guàn cháng
刘静怡: liú jìng yí
收效: shōu xiào
误入: wù rù
张忠谋: zhāng zhōng móu
嫉妒: jí dù
带动性: dài dòng xìng
儒生: rú shēng
ＧＤＰ: Ｇ Ｄ Ｐ
邻人: lín rén
二十五日: èr shí wǔ rì
借牌: jiè pái
民用: mín yòng
生死: shēng sǐ
民生: mín shēng
心急: xīn jí
颁奖: bān jiǎng
法津: fǎ jīn
罗东: luó dōng
奢侈: shē chǐ
收成: shōu chéng
杀出: shā chū
侦测: zhēn cè
今後: jīn hòu
琉璃: liú lí
径自: jìng zì
香功: xiāng gōng
芳踪: fāng zōng
关锦鹏: guān jǐn péng
借用: jiè yòng
後面: hòu miàn
２１８１．７７: ２ １ ８ １ ． ７ ７
严师: yán shī
影音: yǐng yīn
水源: shuǐ yuán
５日: ５ rì
自带: zì dài
生涯: shēng yá
满贯: mǎn guàn
惨痛: cǎn tòng
嫁入: jià rù
水滨: shuǐ bīn
痛哭流涕: tòng kū liú tì
桥面: qiáo miàn
自废: zì fèi
後院: hòu yuàn
躲到: duǒ dào
钞文: chāo wén
网网: wǎng wǎng
手铐: shǒu kào
黔西: qián xī
纳归: nà guī
胡须: hú xū
架设: jià shè
坡壁: pō bì
宽心: kuān xīn
姜岩: jiāng yán
源出: yuán chū
负责制: fù zé zhì
元人: yuán rén
乡林: xiāng lín
釉俑: yòu yǒng
水流: shuǐ liú
元代: yuán dài
版面: bǎn miàn
束□: shù □
水沟: shuǐ gōu
玉米条: yù mǐ tiáo
萧琼瑞: xiāo qióng ruì
自小: zì xiǎo
选定: xuǎn dìng
乡人: xiāng rén
街友: jiē yǒu
拜师: bài shī
爱国: ài guó
法源: fǎ yuán
购进: gòu jìn
独特: dú tè
AC: A C
特效药: tè xiào yào
宽带: kuān dài
AV: A V
右图: yòu tú
乡下: xiāng xià
纽西兰: niǔ xī lán
周履靖: zhōu lǚ jìng
定案: dìng àn
旅程: lǚ chéng
李鹏: lǐ péng
电影人: diàn yǐng rén
峥嵘: zhēng róng
纳入: nà rù
自危: zì wēi
四亿: sì yì
饭店: fàn diàn
质问: zhì wèn
宰羊: zǎi yáng
贸然: mào rán
生态: shēng tài
崩蚀: bēng shí
危险性: wēi xiǎn xìng
日报: rì bào
85: 8 5
民航业: mín háng yè
官民: guān mín
五点四亿: wǔ diǎn sì yì
自制: zì zhì
满腹: mǎn fù
就学: jiù xué
断交: duàn jiāo
０．０１: ０ ． ０ １
自动: zì dòng
自力: zì lì
袁世海: yuán shì hǎi
眉宇: méi yǔ
误导: wù dǎo
网点: wǎng diǎn
丘丘: qiū qiū
银带鲫: yín dài jì
农民们: nóng mín men
收汇: shōu huì
彩云: cǎi yún
今冬: jīn dōng
茅威涛: máo wēi tāo
碰撞: pèng zhuàng
鞭策: biān cè
爱宝: ài bǎo
严竣: yán jùn
李鲲: lǐ kūn
腰花: yāo huā
姜军: jiāng jūn
痛心: tòng xīn
水患: shuǐ huàn
五点三: wǔ diǎn sān
修持: xiū chí
器物: qì wù
雪坛: xuě tán
选址: xuǎn zhǐ
篆书: zhuàn shū
二成四: èr chéng sì
涛音: tāo yīn
海芙纳: hǎi fú nà
器用: qì yòng
１日: １ rì
友人: yǒu rén
渊薮: yuān sǒu
队友: duì yǒu
做法: zuò fǎ
伪劣: wěi liè
货船: huò chuán
诉讼: sù sòng
病人: bìng rén
法文: fǎ wén
陈玉峰: chén yù fēng
电影法: diàn yǐng fǎ
诉诸: sù zhū
习俗: xí sú
8810: 8 8 1 0
罪状: zuì zhuàng
罪犯: zuì fàn
扩张: kuò zhāng
牧归: mù guī
修整: xiū zhěng
用词: yòng cí
涠洲岛: wéi zhōu dǎo
选冶: xuǎn yě
生日: shēng rì
旅美: lǚ měi
You: Y o u
私密性: sī mì xìng
哲学性: zhé xué xìng
十多亿: shí duō yì
纺成: fǎng chéng
尖锐: jiān ruì
生效: shēng xiào
撤回国: chè huí guó
弃如敝屣: qì rú bì xǐ
馀力: yú lì
讲法: jiǎng fǎ
林玲玲: lín líng líng
汉城: hàn chéng
讯连: xùn lián
爱心: ài xīn
老饕们: lǎo tāo men
网球: wǎng qiú
心防: xīn fáng
总值: zǒng zhí
讲求: jiǎng qiú
Johnny: J o h n n y
敲锣: qiāo luó
IDC: I D C
电剪: diàn jiǎn
败类: bài lèi
流动性: liú dòng xìng
环山: huán shān
心音: xīn yīn
总关: zǒng guān
日日: rì rì
归集额: guī jí é
交流史: jiāo liú shǐ
益民: yì mín
今后: jīn hòu
鲈鱼: lú yú
日文: rì wén
赤水河: chì shuǐ hé
生来: shēng lái
凝聚: níng jù
李永坤: lǐ yǒng kūn
领舞: lǐng wǔ
午後: wǔ hòu
全境: quán jìng
改制: gǎi zhì
Tapu: T a p u
悬殊: xuán shū
筛检: shāi jiǎn
茶点: chá diǎn
辛劳: xīn láo
低廉: dī lián
办公厅: bàn gōng tīng
捞起: lāo qǐ
富裕: fù yù
人潮: rén cháo
吸引人: xī yǐn rén
低座: dī zuò
退烧: tuì shāo
点点滴滴: diǎn diǎn dī dī
护渔: hù yú
简历: jiǎn lì
出口值: chū kǒu zhí
资讯史: zī xùn shǐ
０．９: ０ ． ９
０．３: ０ ． ３
窜出: cuàn chū
林美伦: lín měi lún
锺佩珍: zhōng pèi zhēn
就渎: jiù dú
保证: bǎo zhèng
企求: qǐ qiú
未来: wèi lái
李建民: lǐ jiàn mín
改变: gǎi biàn
孳息: zī xī
图纸: tú zhǐ
文学类: wén xué lèi
新品: xīn pǐn
悟出: wù chū
记性: jì xìng
总产: zǒng chǎn
获赠: huò zèng
求职: qiú zhí
携带: xié dài
世界性: shì jiè xìng
罗罗: luó luó
签字: qiān zì
改做: gǎi zuò
洪秀全: hóng xiù quán
第十四: dì shí sì
每每: měi měi
新型: xīn xíng
顺手: shùn shǒu
电文: diàn wén
礼物: lǐ wù
人流: rén liú
６２６亿: ６ ２ ６ yì
珍贵: zhēn guì
C.I.T.: C . I . T .
拳赛: quán sài
065: 0 6 5
064: 0 6 4
069: 0 6 9
药检: yào jiǎn
申尊敬: shēn zūn jìng
BBS: B B S
住屋: zhù wū
工匠们: gōng jiàng men
窜升: cuàn shēng
人民: rén mín
蒋曼琪: jiǎng màn qí
紧张性: jǐn zhāng xìng
时装: shí zhuāng
疼痛: téng tòng
画下: huà xià
疼爱: téng ài
资讯国: zī xùn guó
爱情剧: ài qíng jù
林木: lín mù
瓶罐: píng guàn
就此: jiù cǐ
悲剧性: bēi jù xìng
11: 1 1
新党: xīn dǎng
实验网: shí yàn wǎng
订制: dìng zhì
三彩釉: sān cǎi yòu
热诚: rè chéng
铁器: tiě qì
检举: jiǎn jǔ
推展: tuī zhǎn
改回: gǎi huí
惠东: huì dōng
云辰: yún chén
第「十三」: dì 「 shí sān 」
面海: miàn hǎi
利润: lì rùn
抽出: chōu chū
赛季: sài jì
CK: C K
世界杯: shì jiè bēi
领导者: lǐng dǎo zhě
CD: C D
富贵: fù guì
23482195: 2 3 4 8 2 1 9 5
23482192: 2 3 4 8 2 1 9 2
摊贩: tān fàn
面水: miàn shuǐ
邮费: yóu fèi
谈判权: tán pàn quán
刑诉法: xíng sù fǎ
李默然: lǐ mò rán
巍巍: wēi wēi
２４００: ２ ４ ０ ０
电报: diàn bào
推崇: tuī chóng
摆荡: bǎi dàng
News: N e w s
装置: zhuāng zhì
延缓: yán huǎn
4.11: 4 . 1 1
扬基债: yáng jī zhài
情报志: qíng bào zhì
联外: lián wài
PTA: P T A
纺纱: fǎng shā
午夜: wǔ yè
扼腕: è wàn
装修: zhuāng xiū
城乡所: chéng xiāng suǒ
利民: lì mín
防伪: fáng wěi
DNA: D N A
苏辙: sū zhé
费负: fèi fù
训话: xùn huà
延续: yán xù
哭嫁: kū jià
旗帜: qí zhì
改善: gǎi shàn
计时器: jì shí qì
推开: tuī kāi
悬挂: xuán guà
摆起: bǎi qǐ
存水: cún shuǐ
报端: bào duān
乡镇级: xiāng zhèn jí
富者: fù zhě
钟山: zhōng shān
褒贬: bāo biǎn
办公室: bàn gōng shì
老乡: lǎo xiāng
录音师: lù yīn shī
西峡县: xī xiá xiàn
人望: rén wàng
抽屉: chōu tì
老三: lǎo sān
实验班: shí yàn bān
人权: rén quán
画符: huà fú
推出: tuī chū
赛坛: sài tán
14.93: 1 4 . 9 3
代理人: dài lǐ rén
ＷＢＣ: Ｗ Ｂ Ｃ
资讯室: zī xùn shì
----: - - - -
欠债: qiàn zhài
停靠: tíng kào
影响力: yǐng xiǎng lì
延烧: yán shāo
凝视: níng shì
寂静: jì jìng
推入: tuī rù
傻瓜: shǎ guā
电源: diàn yuán
染整: rǎn zhěng
预赛: yù sài
替代: tì dài
佩带: pèi dài
闲静: xián jìng
民权: mín quán
图画: tú huà
推动: tuī dòng
刮来: guā lái
朋友们: péng yǒu men
文词: wén cí
工矿业: gōng kuàng yè
抓举: zhuā jǔ
推到: tuī dào
2703-4715: 2 7 0 3 - 4 7 1 5
雪铁龙: xuě tiě lóng
病变: bìng biàn
酒类: jiǔ lèi
性欲: xìng yù
新帽: xīn mào
宜兰县: yí lán xiàn
窥出: kuī chū
偷翻: tōu fān
李沛瑶: lǐ pèi yáo
CHINA: C H I N A
组装: zǔ zhuāng
报社: bào shè
抓住: zhuā zhù
签收: qiān shōu
图书馆: tú shū guǎn
新建: xīn jiàn
报纸: bào zhǐ
速生丰: sù shēng fēng
生命力: shēng mìng lì
6.52: 6 . 5 2
签报: qiān bào
存档: cún dàng
改建: gǎi jiàn
十字绣: shí zì xiù
选举权: xuǎn jǔ quán
低劣: dī liè
药材: yào cái
住友: zhù yǒu
Melihi: M e l i h i
推向: tuī xiàng
向心力: xiàng xīn lì
申办: shēn bàn
专职: zhuān zhí
厚生: hòu shēng
堂堂: táng táng
新境: xīn jìng
展望: zhǎn wàng
护鱼队: hù yú duì
展板: zhǎn bǎn
丹麦: dān mài
人手: rén shǒu
水面: shuǐ miàn
马悦然: mǎ yuè rán
匍匐: pú fú
松花江: sōng huā jiāng
订定: dìng dìng
偷窥: tōu kuī
慑人: shè rén
预备役: yù bèi yì
响起: xiǎng qǐ
刮损: guā sǔn
Y字型: Y zì xíng
汐止镇: xī zhǐ zhèn
紧急: jǐn jí
摄入: shè rù
172: 1 7 2
资讯展: zī xùn zhǎn
药效: yào xiào
钦点: qīn diǎn
珠海: zhū hǎi
摆设: bǎi shè
悠哉: yōu zāi
新娘: xīn niáng
预订: yù dìng
预计: yù jì
预设: yù shè
新婚: xīn hūn
人情: rén qíng
伤残者: shāng cán zhě
企业局: qǐ yè jú
人性: rén xìng
萧山: xiāo shān
电视史: diàn shì shǐ
验孕: yàn yùn
珠江: zhū jiāng
凝聚力: níng jù lì
床板: chuáng bǎn
人群: rén qún
装备: zhuāng bèi
利笔: lì bǐ
浮动班: fú dòng bān
秦祥林: qín xiáng lín
鳗鱼: mán yú
疾病: jí bìng
维生: wéi shēng
人缘: rén yuán
工业局: gōng yè jú
茶情: chá qíng
林班: lín bān
胡文瑞: hú wén ruì
西商: xī shāng
影评人: yǐng píng rén
龚固尔: gōng gù ěr
滚动: gǔn dòng
３０００: ３ ０ ０ ０
电视界: diàn shì jiè
库务局: kù wù jú
二十二亿: èr shí èr yì
闲谈: xián tán
制剂: zhì jì
潮水: cháo shuǐ
签署: qiān shǔ
住人: zhù rén
撞击: zhuàng jī
送来: sòng lái
黄炯毓: huáng jiǒng yù
就绪: jiù xù
停靠点: tíng kào diǎn
８９: ８ ９
８２: ８ ２
毕业: bì yè
鱼塘: yú táng
礼拜: lǐ bài
建管权: jiàn guǎn quán
COOLPLUS: C O O L P L U S
染织: rǎn zhī
预防: yù fáng
代理商: dài lǐ shāng
EG: E G
EC: E C
腐败: fǔ bài
制出: zhì chū
险峻: xiǎn jùn
因循: yīn xún
毕惠罗: bì huì luó
骂成: mà chéng
形势: xíng shì
潜水: qián shuǐ
男士们: nán shì men
文案: wén àn
71.83: 7 1 . 8 3
龙门: lóng mén
笔记: bǐ jì
紧紧: jǐn jǐn
形制: xíng zhì
三资: sān zī
林宜: lín yí
贯彻: guàn chè
规定: guī dìng
人类: rén lèi
输送: shū sòng
竣工: jùn gōng
云林县: yún lín xiàn
刘天健: liú tiān jiàn
３００: ３ ０ ０
３０５: ３ ０ ５
芬兰: fēn lán
萨国: sà guó
Pangcah: P a n g c a h
就算: jiù suàn
交响: jiāo xiǎng
防卫网: fáng wèi wǎng
私塾: sī shú
西元: xī yuán
老友: lǎo yǒu
小型张: xiǎo xíng zhāng
面粉: miàn fěn
陈志宽: chén zhì kuān
忙成: máng chéng
展翅: zhǎn chì
特设: tè shè
顺畅: shùn chàng
泉州: quán zhōu
录影带: lù yǐng dài
礼敬: lǐ jìng
人权日: rén quán rì
努力: nǔ lì
牦牛: máo niú
○○: ○ ○
航天局: háng tiān jú
欠佳: qiàn jiā
巴国: bā guó
顺益: shùn yì
西历: xī lì
斟酌: zhēn zhuó
宜兰人: yí lán rén
画室: huà shì
企管: qǐ guǎn
９·６８７: ９ · ６ ８ ７
湄公河: méi gōng hé
饥饿: jī è
推举: tuī jǔ
凝静: níng jìng
面纱: miàn shā
记者: jì zhě
面线: miàn xiàn
防弊: fáng bì
１１日: １ １ rì
毅力: yì lì
图案: tú àn
显现: xiǎn xiàn
三点二亿: sān diǎn èr yì
报时: bào shí
老农: lǎo nóng
回避: huí bì
付出: fù chū
三西: sān xī
老公: lǎo gōng
老兵: lǎo bīng
延滞: yán zhì
规律: guī lǜ
旗下: qí xià
制品: zhì pǐn
报效: bào xiào
获颁: huò bān
2000: 2 0 0 0
2001: 2 0 0 1
形如: xíng rú
惯用: guàn yòng
海岸线: hǎi àn xiàn
巴士: bā shì
护盘: hù pán
电缆: diàn lǎn
鼓山镇: gǔ shān zhèn
工业品: gōng yè pǐn
９·７２５: ９ · ７ ２ ５
订下: dìng xià
蒺藜: jí lí
抛开: pāo kāi
谢军: xiè jūn
巴塘: bā táng
宠物: chǒng wù
邮递: yóu dì
紧锣密鼓: jǐn luó mì gǔ
扩张史: kuò zhāng shǐ
辅导: fǔ dǎo
制定: zhì dìng
富邦: fù bāng
ZDNet: Z D N e t
宠爱: chǒng ài
统帅: tǒng shuài
记述: jì shù
企画: qǐ huà
西岸: xī àn
凤飞飞: fèng fēi fēi
响马: xiǎng mǎ
灰尘: huī chén
第２０: dì ２ ０
茶楼: chá lóu
糕点: gāo diǎn
１４日: １ ４ rì
松花砚: sōng huā yàn
烹饪: pēng rèn
丑男: chǒu nán
ABS: A B S
惠卿: huì qīng
电线: diàn xiàn
药物: yào wù
克罗维茨: kè luó wéi cí
形塑: xíng sù
第十二: dì shí èr
西德: xī dé
第十五: dì shí wǔ
铜冶: tóng yě
锁定: suǒ dìng
ext.: e x t .
威海: wēi hǎi
避热: bì rè
规则: guī zé
工业国: gōng yè guó
热门: rè mén
装卸: zhuāng xiè
热闹: rè nào
第十三: dì shí sān
偷渡: tōu dù
浇灭: jiāo miè
冀东: jì dōng
画坛: huà tán
人生: rén shēng
防务: fáng wù
KTV: K T V
谭咏麟: tán yǒng lín
滥葬: làn zàng
存续: cún xù
抽丝: chōu sī
欧洲人: ōu zhōu rén
银货两讫: yín huò liǎng qì
图文: tú wén
画图: huà tú
袁晔: yuán yè
群集: qún jí
群雄: qún xióng
Association: A s s o c i a t i o n
迪马: dí mǎ
电视网: diàn shì wǎng
陈忠: chén zhōng
巴宰: bā zǎi
防卫: fáng wèi
胡锁锦: hú suǒ jǐn
水务署: shuǐ wù shǔ
新人: xīn rén
惠元: huì yuán
画出: huà chū
推拿: tuī ná
汉武帝: hàn wǔ dì
资讯人: zī xùn rén
SONY: S O N Y
慈善: cí shàn
动植物: dòng zhí wù
欧姆龙: ōu mǔ lóng
世界级: shì jiè jí
西天: xī tiān
媚俗: mèi sú
巴山: bā shān
迢迢: tiáo tiáo
巴尔: bā ěr
下笔: xià bǐ
男装: nán zhuāng
想法: xiǎng fǎ
洛克: luò kè
吸引力: xī yǐn lì
资讯业: zī xùn yè
三菱: sān líng
画像: huà xiàng
谱成: pǔ chéng
熠熠: yì yì
妹妹: mèi mèi
老实: lǎo shí
云雾: yún wù
电流: diàn liú
云集: yún jí
126.06: 1 2 6 . 0 6
Marcus: M a r c u s
人物: rén wù
电窑: diàn yáo
铜器: tóng qì
酒楼: jiǔ lóu
西安: xī ān
效益型: xiào yì xíng
停职: tíng zhí
私帐: sī zhàng
蒋志敏: jiǎng zhì mǐn
Excel: E x c e l
回首: huí shǒu
回馈: huí kuì
云门: yún mén
笃定: dǔ dìng
Howick: H o w i c k
西学: xī xué
三者: sān zhě
患病: huàn bìng
霉素: méi sù
远征: yuǎn zhēng
老妈: lǎo mā
面目: miàn mù
２１日: ２ １ rì
厚望: hòu wàng
回顾: huí gù
获选: huò xuǎn
张爱玲: zhāng ài líng
林献仁: lín xiàn rén
仕绅: shì shēn
护照: hù zhào
盗录: dào lù
自闭: zì bì
老外: lǎo wài
防城: fáng chéng
Stewart: S t e w a r t
斑斑: bān bān
获邀: huò yāo
岁暮: suì mù
龙饰: lóng shì
功学社: gōng xué shè
新生: xīn shēng
劳资: láo zī
坪林: píng lín
酒坛: jiǔ tán
话剧: huà jù
败诉者: bài sù zhě
原装: yuán zhuāng
１７．２７: １ ７ ． ２ ７
海防法: hǎi fáng fǎ
新界: xīn jiè
徜徉: cháng yáng
鲟鱼: xún yú
人俑: rén yǒng
黄菊: huáng jú
报到: bào dào
实验室: shí yàn shì
报刊: bào kān
赢面: yíng miàn
低级: dī jí
潜心: qián xīn
胃药: wèi yào
浓郁: nóng yù
人人: rén rén
小心翼翼: xiǎo xīn yì yì
制成: zhì chéng
戴荣辉: dài róng huī
就业: jiù yè
帐面: zhàng miàn
考生: kǎo shēng
退党: tuì dǎng
must: m u s t
盐渍藕: yán zì ǒu
访谈: fǎng tán
新闻人: xīn wén rén
COPYRIGHT: C O P Y R I G H T
９４．２３: ９ ４ ． ２ ３
老来: lǎo lái
形态: xíng tài
李晴扬: lǐ qíng yáng
威士忌: wēi shì jì
人世: rén shì
茶农: chá nóng
老板: lǎo bǎn
入阁: rù gé
退出: tuì chū
入门: rù mén
三点五三: sān diǎn wǔ sān
酒商: jiǔ shāng
星巴克: xīng bā kè
黄凤珍: huáng fèng zhēn
变迁: biàn qiān
寄送: jì sòng
做田: zuò tián
桓宽: huán kuān
Ｇｅｎｅｒａｌ: Ｇ ｅ ｎ ｅ ｒ ａ ｌ
15.02: 1 5 . 0 2
三点五亿: sān diǎn wǔ yì
对象国: duì xiàng guó
攻坚战: gōng jiān zhàn
花费: huā fèi
罗德: luó dé
延宕: yán dàng
老旧: lǎo jiù
首府: shǒu fǔ
胃肠: wèi cháng
００３０１１: ０ ０ ３ ０ １ １
巴掌: bā zhǎng
推算: tuī suàn
防止: fáng zhǐ
企图: qǐ tú
山药: shān yào
1971: 1 9 7 1
马友友: mǎ yǒu yǒu
侬侬: nóng nóng
顶级: dǐng jí
钦州: qīn zhōu
贝雕: bèi diāo
厚实: hòu shí
企业: qǐ yè
the: t h e
报关: bào guān
十字军: shí zì jūn
Ita: I t a
Its: I t s
污染源: wū rǎn yuán
防水: fáng shuǐ
程序表: chéng xù biǎo
窝点: wō diǎn
幻境: huàn jìng
保养品: bǎo yǎng pǐn
防汛: fáng xùn
报国: bào guó
赛程: sài chéng
替换: tì huàn
德国犬: dé guó quǎn
人权周: rén quán zhōu
简直: jiǎn zhí
老手: lǎo shǒu
６４．２４亿: ６ ４ ． ２ ４ yì
访视: fǎng shì
染整业: rǎn zhěng yè
芳香: fāng xiāng
偷偷: tōu tōu
付托: fù tuō
张劭聿: zhāng shào yù
Ｓｉｒ: Ｓ ｉ ｒ
送到: sòng dào
男队: nán duì
１４００: １ ４ ０ ０
飞速: fēi sù
觥筹: gōng chóu
bathroom: b a t h r o o m
疏迁: shū qiān
舞者: wǔ zhě
民情: mín qíng
防洪: fáng hóng
乡志: xiāng zhì
简短: jiǎn duǎn
叫买: jiào mǎi
宋吉雄: sòng jí xióng
催命符: cuī mìng fú
药专: yào zhuān
新点: xīn diǎn
品质: pǐn zhì
歌星: gē xīng
钜资: jù zī
铁矿: tiě kuàng
进口自: jìn kǒu zì
９０００: ９ ０ ０ ０
０２: ０ ２
０１: ０ １
０４: ０ ４
卫冕战: wèi miǎn zhàn
０９: ０ ９
情报网: qíng bào wǎng
产物: chǎn wù
世界杯赛: shì jiè bēi sài
营志宏: yíng zhì hóng
企业界: qǐ yè jiè
出自: chū zì
偷到: tōu dào
试验: shì yàn
１９日: １ ９ rì
退回: tuì huí
毕竟: bì jìng
延後: yán hòu
认输: rèn shū
锦缎: jǐn duàn
推翻: tuī fān
检测: jiǎn cè
秭归: zǐ guī
锦绣: jǐn xiù
茶圆: chá yuán
糯米糕: nuò mǐ gāo
村民们: cūn mín men
铁画: tiě huà
改用: gǎi yòng
宾士: bīn shì
讪笑: shàn xiào
殊荣: shū róng
千馀: qiān yú
面临: miàn lín
送入: sòng rù
西成: xī chéng
面世: miàn shì
因此: yīn cǐ
Double: D o u b l e
三千多: sān qiān duō
授权: shòu quán
入选: rù xuǎn
装满: zhuāng mǎn
远来: yuǎn lái
1949: 1 9 4 9
潜在: qián zài
制止: zhì zhǐ
改稿: gǎi gǎo
海贝: hǎi bèi
段段: duàn duàn
嘉义: jiā yì
来势汹汹: lái shì xiōng xiōng
音译: yīn yì
第三十四: dì sān shí sì
岁出: suì chū
修纂: xiū zuǎn
恼人: nǎo rén
悔恨: huǐ hèn
酷酷: kù kù
向後: xiàng hòu
订置: dìng zhì
恋爱: liàn ài
进口货: jìn kǒu huò
甩开: shuǎi kāi
林晏弘: lín yàn hóng
电业: diàn yè
资讯管: zī xùn guǎn
报导: bào dǎo
吸音: xī yīn
慈悲: cí bēi
建管局: jiàn guǎn jú
酒师: jiǔ shī
扬州: yáng zhōu
B型: B xíng
西江: xī jiāng
攻向: gōng xiàng
酒店: jiǔ diàn
轨距: guǐ jù
西汉: xī hàn
老法: lǎo fǎ
出走: chū zǒu
出资: chū zī
犁具: lí jù
出赛: chū sài
茶娘: chá niáng
张持坚: zhāng chí jiān
画架: huà jià
出货: chū huò
攻坚: gōng jiān
花蕾: huā lěi
防护: fáng hù
友善: yǒu shàn
新翼: xīn yì
影视界: yǐng shì jiè
防拦: fáng lán
６４０亿: ６ ４ ０ yì
妈妈: mā mā
20.11: 2 0 . 1 1
日记: rì jì
宝贝: bǎo bèi
扬弃: yáng qì
下文: xià wén
PDA: P D A
四海帮: sì hǎi bāng
退学: tuì xué
先民们: xiān mín men
烤鸭: kǎo yā
茶室: chá shì
文学界: wén xué jiè
928: 9 2 8
茶宴: chá yàn
报复: bào fù
报备: bào bèi
阴阳: yīn yáng
美钞: měi chāo
轨迹: guǐ jī
厚厚: hòu hòu
迪·多米: dí · duō mǐ
攻击: gōng jī
新社: xīn shè
卖钱: mài qián
钧瓷瓶: jūn cí píng
１６日: １ ６ rì
束缚: shù fù
业馀: yè yú
视距: shì jù
茶山: chá shān
常人: cháng rén
花莲: huā lián
３２００: ３ ２ ０ ０
牵起: qiān qǐ
坚韧: jiān rèn
攻关: gōng guān
防撞: fáng zhuàng
忆起: yì qǐ
改组: gǎi zǔ
飘逸: piāo yì
学者: xué zhě
周碧瑟: zhōu bì sè
出让: chū ràng
项目: xiàng mù
惠普: huì pǔ
新秀: xīn xiù
出访: chū fǎng
咨询业: zī xún yè
21: 2 1
22: 2 2
推理: tuī lǐ
28: 2 8
十字形: shí zì xíng
风水缸: fēng shuǐ gāng
图利: tú lì
纠纷: jiū fēn
花花: huā huā
织出: zhī chū
改编: gǎi biān
氨伦丝: ān lún sī
潜力: qián lì
入驻: rù zhù
花艺: huā yì
咒骂: zhòu mà
I.: I .
欺骗: qī piàn
榨出: zhà chū
试生产: shì shēng chǎn
IQ: I Q
人类学者: rén lèi xué zhě
IC: I C
防旱: fáng hàn
突破性: tū pò xìng
临到: lín dào
跟出: gēn chū
协议书: xié yì shū
玫瑰: méi guī
战士们: zhàn shì men
新签: xīn qiān
花腰: huā yāo
谱出: pǔ chū
牵连: qiān lián
宽严: kuān yán
浦江: pǔ jiāng
鼓动: gǔ dòng
４８: ４ ８
４９: ４ ９
４６: ４ ６
４７: ４ ７
４４: ４ ４
４２: ４ ２
４３: ４ ３
４０: ４ ０
险情: xiǎn qíng
攻势: gōng shì
退役: tuì yì
抽签: chōu qiān
4.1: 4 . 1
图像: tú xiàng
浦海: pǔ hǎi
勋衔: xūn xián
CNN: C N N
画成: huà chéng
新竹: xīn zhú
撑起: chēng qǐ
出面: chū miàn
永久性: yǒng jiǔ xìng
简报: jiǎn bào
ＡＴＭ: Ａ Ｔ Ｍ
骄人: jiāo rén
铜管: tóng guǎn
逃汇: táo huì
Juicy: J u i c y
人心: rén xīn
三千亿: sān qiān yì
改成: gǎi chéng
遥遥领先: yáo yáo lǐng xiān
外型美: wài xíng měi
规画: guī huà
花鼓: huā gǔ
人形: rén xíng
林口: lín kǒu
资讯战: zī xùn zhàn
低潮: dī cháo
Ａ３２０: Ａ ３ ２ ０
展室: zhǎn shì
图书: tú shū
脍炙人口: kuài zhì rén kǒu
电器: diàn qì
出阵: chū zhèn
谱下: pǔ xià
１．５亿: １ ． ５ yì
西瓜: xī guā
诸如此类: zhū rú cǐ lèi
喂奶: wèi nǎi
肾病: shèn bìng
违规者: wéi guī zhě
因素: yīn sù
阴谋: yīn móu
紧张: jǐn zhāng
林务: lín wù
命题: mìng tí
３７７６: ３ ７ ７ ６
护卫者: hù wèi zhě
就座: jiù zuò
don't: d o n ' t
鲁杰罗: lǔ jié luó
洛美: luò měi
利多: lì duō
新村: xīn cūn
规程: guī chéng
人工: rén gōng
顺势: shùn shì
电唁: diàn yàn
面对: miàn duì
美资: měi zī
出错: chū cuò
博士班: bó shì bān
出门: chū mén
利国: lì guó
12: 1 2
顺利: shùn lì
3.03: 3 . 0 3
擦拭: cā shì
面孔: miàn kǒng
围墙: wéi qiáng
美谈: měi tán
住民: zhù mín
飘进: piāo jìn
冀望: jì wàng
钟架: zhōng jià
因缘: yīn yuán
张艺谋: zhāng yì móu
拣到: jiǎn dào
出钱: chū qián
词藻: cí zǎo
宝法德: bǎo fǎ dé
逝者: shì zhě
亦师亦友: yì shī yì yǒu
学额: xué é
展览品: zhǎn lǎn pǐn
统独: tǒng dú
擒获: qín huò
展延: zhǎn yán
人寿: rén shòu
杨希伟: yáng xī wěi
１３２０: １ ３ ２ ０
定远县: dìng yuǎn xiàn
老牌: lǎo pái
简易: jiǎn yì
are: a r e
贡热镇: gòng rè zhèn
订报: dìng bào
萧条: xiāo tiáo
旗津: qí jīn
帝国: dì guó
老爷: lǎo yé
老爸: lǎo bà
惠群: huì qún
紧实: jǐn shí
眉目: méi mù
鱼缸: yú gāng
签定: qiān dìng
紧密: jǐn mì
７８８０亿: ７ ８ ８ ０ yì
美誉: měi yù
叫座: jiào zuò
统筹局: tǒng chóu jú
推测: tuī cè
展开: zhǎn kāi
灰烬: huī jìn
避开: bì kāi
电力: diàn lì
业者: yè zhě
张照东: zhāng zhào dōng
鱼群: yú qún
１２６亿: １ ２ ６ yì
赛段: sài duàn
益仲轩: yì zhòng xuān
制盐: zhì yán
电动: diàn dòng
护士: hù shì
鱼类: yú lèi
礼仪: lǐ yí
花香: huā xiāng
延伸: yán shēn
电视剧: diàn shì jù
五点五四: wǔ diǎn wǔ sì
宜兰湾: yí lán wān
防线: fáng xiàn
宣誓: xuān shì
林玉婷: lín yù tíng
TVBS: T V B S
巅峰: diān fēng
飞舞: fēi wǔ
飞船: fēi chuán
飞航: fēi háng
人士: rén shì
入股: rù gǔ
新手: xīn shǒu
检索: jiǎn suǒ
锁国: suǒ guó
116: 1 1 6
借鉴: jiè jiàn
尴尬: gān gà
奉公: fèng gōng
赋闲: fù xián
试试: shì shì
scroll: s c r o l l
统统: tǒng tǒng
老细: lǎo xì
二○三: èr ○ sān
电影: diàn yǐng
UAA: U A A
敏锐: mǐn ruì
交代: jiāo dài
生物学: shēng wù xué
８０: ８ ０
８１: ８ １
８６: ８ ６
８５: ８ ５
送交: sòng jiāo
山顶: shān dǐng
防灾: fáng zāi
飞赴: fēi fù
飘萍: piāo píng
访问: fǎng wèn
黄国城: huáng guó chéng
保肝: bǎo gān
冀求: jì qiú
飞跃: fēi yuè
制程: zhì chéng
叫到: jiào dào
未必: wèi bì
老美: lǎo měi
学问: xué wèn
细流: xì liú
酒业: jiǔ yè
0.5: 0 . 5
护坡: hù pō
晚霞: wǎn xiá
面值: miàn zhí
测算: cè suàn
催花: cuī huā
药剂: yào jì
工业界: gōng yè jiè
BAND: B A N D
铜牌: tóng pái
抓紧: zhuā jǐn
生命权: shēng mìng quán
TOYOTA: T O Y O T A
dobro: d o b r o
掐住: qiā zhù
二十二日: èr shí èr rì
贴膜: tiē mó
成交额: chéng jiāo é
势如破竹: shì rú pò zhú
欺负: qī fù
柯建铭: kē jiàn míng
办公楼: bàn gōng lóu
玻尔: bō ěr
新潮: xīn cháo
胰岛素: yí dǎo sù
存废: cún fèi
推手: tuī shǒu
入赘: rù zhuì
电工: diàn gōng
热闹滚滚: rè nào gǔn gǔn
译音: yì yīn
学院: xué yuàn
李仲生: lǐ zhòng shēng
未尝: wèi cháng
阵线: zhèn xiàn
安西: ān xī
西线: xī xiàn
９·９１２: ９ · ９ １ ２
二乔玉兰: èr qiáo yù lán
展出: zhǎn chū
花钟: huā zhōng
叫停: jiào tíng
情报战: qíng bào zhàn
恋恋: liàn liàn
人品: rén pǐn
升官: shēng guān
Ｇｕｔｈｒｉｅ: Ｇ ｕ ｔ ｈ ｒ ｉ ｅ
锺建志: zhōng jiàn zhì
人命: rén mìng
推挤: tuī jǐ
５００多: ５ ０ ０ duō
怯懦: qiè nuò
抽检: chōu jiǎn
炒菜锅: chǎo cài guō
鞑伐: dá fá
人口: rén kǒu
文莱: wén lái
进口额: jìn kǒu é
未婚: wèi hūn
利基: lì jī
６２亿: ６ ２ yì
鱼皮: yú pí
欺诈: qī zhà
出马: chū mǎ
师生: shī shēng
DVD: D V D
存够: cún gòu
住户: zhù hù
秀峦村: xiù luán cūn
档案: dàng àn
黄鹤: huáng hè
苏梅克: sū méi kè
访遍: fǎng biàn
人力: rén lì
１．４７: １ ． ４ ７
bbs: b b s
嘉定: jiā dìng
新案: xīn àn
钟楼: zhōng lóu
凝聚态: níng jù tài
嘉宾: jiā bīn
申报: shēn bào
护卫: hù wèi
黄黄: huáng huáng
黄默: huáng mò
生态界: shēng tài jiè
统筹: tǒng chóu
面向: miàn xiàng
忿忿: fèn fèn
MTV: M T V
图利罪: tú lì zuì
卓琳: zhuō lín
试航: shì háng
茶乡: chá xiāng
know: k n o w
心存: xīn cún
顺序: shùn xù
携手: xié shǒu
展品: zhǎn pǐn
山麓: shān lù
115: 1 1 5
114: 1 1 4
117: 1 1 7
111: 1 1 1
110: 1 1 0
113: 1 1 3
112: 1 1 2
119: 1 1 9
118: 1 1 8
防皱: fáng zhòu
欢欣: huān xīn
文艺: wén yì
悲悯: bēi mǐn
顺带: shùn dài
慈眉: cí méi
枢密院: shū mì yuàn
退伍: tuì wǔ
负荆请罪: fù jīng qǐng zuì
总协定: zǒng xié dìng
刮到: guā dào
丝质: sī zhì
药品: yào pǐn
顺德: shùn dé
礼俗: lǐ sú
人像: rén xiàng
Golo: G o l o
德黑兰: dé hēi lán
检疫: jiǎn yì
弱质: ruò zhì
美股: měi gǔ
风陵渡: fēng líng dù
博士级: bó shì jí
保护法: bǎo hù fǎ
飘荡: piāo dàng
